yivo	gold	bleaman	uroman
אָב	ob	ob	ob
אָבֿ	ov	ov	ov
אָבֿינו	ovinu	ovinu	ovynu
אָבלאַסט	oblast	oblast	oblast
אַגענט	agent	agent	agent
אָגער	oger	oger	oger
אַגרעס	agres	agres	agres
אַדאַפּטירער	adaptirer	adaptirer	adaptyrer
אַדװאָקאַט	advokat	advokat	advokat
אַדװערב	adverb	adverb	adverb
אַדיעקטיװ	adyektiv	adyektiv	adyektyv
אַדל	adl	adl	adl
אָדלער	odler	odler	odler
אָדער	oder	oder	oder
אָדערל	oderl	oderl	oderl
אָדר	oder	oder	odr
אַדרעס	adres	adres	adres
אַװטאָגראַף	avtograf	avtograf	avtograf
אַװטאָר	avtor	avtor	avtor
אָװנט	ovnt	ovnt	ovnt
אָװנטשטערן	ovntshtern	ovntshtern	ovntshtern
אַזאָט	azot	azot	azot
אַזבוקע	azbuke	azbuke	azbuke
אָזערע	ozere	ozere	ozere
אָזשענע	ozhene	ozhene	ozhene
אַחרון	akhren	akhren	achrun
אַחריות	akhrayes	akhrayes	achryus
אַטאָם	atom	atom	atom
אַטאַק	atak	atak	atak
אַטאַקע	atake	atake	atake
אַטמאָספֿער	atmosfer	atmosfer	atmosfer
אַטמאָספֿערע	atmosfere	atmosfere	atmosfere
אַטעיִזם	ateizm	ateizm	ateizm
אַטעיִסט	ateist	ateist	ateist
אָטעם	otem	otem	otem
אַכטל	akhtl	akhtl	achtl
אַכציקסטל	akhtsikstl	akhtsikstl	achtsykstl
אַכצנטל	akhtsntl	akhtsntl	achtsntl
אַלגעברע	algebre	algebre	algebre
אַלומיניום	aluminyum	aluminyum	alumynyum
אַלטדײַטש	altdaytsh	altdaytsh	altdaytsh
אַלטהויכדײַטש	althoykhdaytsh	althoykhdaytsh	althoychdaytsh
אַלטער	alter	alter	alter
אַליגאַטאָר	aligator	aligator	alygator
אָליװ	oliv	oliv	olyv
אַלמער	almer	almer	almer
אַלעע	alee	alee	alee
אַלערגיע	alergye	alergye	alergye
אַלף	alef	alef	alf
אַלף־בית	alef-beys	alefbeys	alf-bys
אַלפֿאַבעט	alfabet	alfabet	alfabet
אַלקאָהאָל	alkohol	alkohol	alkohol
אַלקאָהאָליזם	alkoholizm	alkoholizm	alkoholyzm
אַם	am	am	am
אַמבאַסאַדע	ambasade	ambasade	ambasade
אַמורא	amoyre	amoyre	amura
אָמלעט	omlet	omlet	omlet
אַמנעזיע	amnezye	amnezye	amnezye
אַמעריקאַנער	amerikaner	amerikaner	amerykaner
אַנאַנאַס	ananas	ananas	ananas
אַנאַרכיזם	anarkhizm	anarkhizm	anarchyzm
אַנאַרכיסט	anarkhist	anarkhist	anarchyst
אָנדענק	ondenk	ondenk	ondenk
אָנהײב	onheyb	onheyb	onhyyb
אָנהײבער	onheyber	onheyber	onhyyber
אַנולירונג	anulirung	anulirung	anulyrung
אַנטאָלאָגיע	antologye	antologye	antologye
אָנטאָלאָגיע	ontologye	ontologye	ontologye
אָנטאָן	onton	onton	onton
אָנטײל	onteyl	onteyl	ontyyl
אָנטײלונג	onteylung	onteylung	ontyylung
אַנטיסעמיט	antisemit	antisemit	antysemyt
אַנטיסעמיטיזם	antisemitizm	antisemitizm	antysemytyzm
אַנטיפּאַטיע	antipatye	antipatye	antypatye
אַנטיק	antik	antik	antyk
אַנטלויף	antloyf	antloyf	antloyf
אַנטלויפֿער	antloyfer	antloyfer	antloyfer
אַנטראָפּאָלאָגיע	antropologye	antropologye	antropologye
אַנטשולדיקונג	antshuldikung	antshuldikung	antshuldykung
אַנסאַמבל	ansambl	ansambl	ansambl
אַנעקדאָט	anekdot	anekdot	anekdot
אָנפֿאַנגער	onfanger	onfanger	onfanger
אָנצינדער	ontsinder	ontsinder	ontsynder
אָנקל	onkl	onkl	onkl
אַנקעטע	ankete	ankete	ankete
אַסטראָנויט	astronoyt	astronoyt	astronoyt
אַסטראָנמיע	astronmye	astronmye	astronmye
אָסיען	osyen	osyen	osyen
אַספּירין	aspirin	aspirin	aspyryn
אַעראָדראָם	aerodrom	aerodrom	aerodrom
אַעראָפּאָרט	aeroport	aeroport	aeroport
אַעראָפּלאַן	aeroplan	aeroplan	aeroplan
אַפֿאָריזם	aforizm	aforizm	aforyzm
אַפּאַטיע	apatye	apatye	apatye
אַפּאָסטאָל	apostol	apostol	apostol
אַפּאַראַטשיק	aparatshik	aparatshik	aparatshyk
אַפּטײק	apteyk	apteyk	aptyyk
אַפּטײקער	apteyker	apteyker	aptyyker
אַפּיקורס	apikoyres	apikoyres	apykurs
אָפּל	opl	opl	opl
אַפּעטיט	apetit	apetit	apetyt
אָפּעראַציע	operatsye	operatsye	operatsye
אָפּערע	opere	opere	opere
אָפּערעטע	operete	operete	operete
אַפּריל	april	april	apryl
אַפּריקאָס	aprikos	aprikos	aprykos
אַפֿיקומן	afikoymen	afikoymen	afykumn
אַפֿריקאַנער	afrikaner	afrikaner	afrykaner
אַפֿריקאַנערין	afrikanerin	afrikanerin	afrykaneryn
אַקאָרדעאָן	akordeon	akordeon	akordeon
אָקופּאַציע	okupatsye	okupatsye	okupatsye
אָקטאָבער	oktober	oktober	oktober
אָקטאָפּוס	oktopus	oktopus	oktopus
אַקטאָר	aktor	aktor	aktor
אַקטיאָר	aktyor	aktyor	aktyor
אַקטיװיטעט	aktivitet	aktivitet	aktyvytet
אַקטיװיסט	aktivist	aktivist	aktyvyst
אַקטריסע	aktrise	aktrise	aktryse
אַקס	aks	aks	aks
אָקס	oks	oks	oks
אַקסל	aksl	aksl	aksl
אָקעאַן	okean	okean	okean
אַקער	aker	aker	aker
אַקער־אײַזן	aker-ayzn	aker-ayzn	aker-aayzn
אַראַביש	arabish	arabish	arabysh
אַראַבער	araber	araber	araber
אַראָמאַט	aromat	aromat	aromat
אַראַמיש	aramish	aramish	aramysh
אַרבעט	arbet	arbet	arbet
אַרבעטער	arbeter	arbeter	arbeter
אַרבעס	arbes	arbes	arbes
אַרבעסזופּ	arbeszup	arbeszup	arbeszup
אַרגאָן	argon	argon	argon
אָרגאַן	organ	organ	organ
אָרגאַניזאַציע	organizatsye	organizatsye	organyzatsye
אַרויסרײד	aroysreyd	aroysreyd	aroysryyd
אַרויסרעד	aroysred	aroysred	aroysred
אַרומנעם	arumnem	arumnem	arumnem
אָרון	orn	orn	orun
אָרון־קודש	orn-koydesh	ornkoydesh	orun-kudsh
אָרט	ort	ort	ort
אָרטאָגראַפֿיע	ortografye	ortografye	ortografye
אָרטאָדאָקס	ortodoks	ortodoks	ortodoks
אָרטאָדאָקסיע	ortodoksiye	ortodoksye	ortodoksye
אַרטיסט	artist	artist	artyst
אַרטיסטקע	artistke	artistke	artystke
אַרטיקל	artikl	artikl	artykl
אַרטישאָק	artishok	artishok	artyshok
אַרטעריע	arterye	arterye	arterye
אָריגינאַל	original	original	orygynal
אַרכיװ	arkhiv	arkhiv	archyv
אַרכיטעקט	arkhitekt	arkhitekt	archytekt
אַרכיטעקטאָר	arkhitektor	arkhitektor	archytektor
אַרכעאָלאָגיע	arkheologye	arkheologye	archeologye
אַרמײ	armey	armey	armyy
אַרמעניש	armenish	armenish	armenysh
אַרמענער	armener	armener	armener
אָרעװניק	orevnik	orevnik	orevnyk
אָרעם	orem	orem	orem
אָרעמאַן	oreman	oreman	oreman
אַרץ	arts	arts	arts
אַרײַנפֿיר	araynfir	araynfir	araynfyr
אַש	ash	ash	ash
אַשבוים	ashboym	ashboym	ashboym
אַשכּנזי	ashkenazi	ashkenazi	ashknzy
אבֿר	eyver	eyver	avr
אדון	adoyn	dun	adun
אדוני	adoyni	duni	aduny
אוגערקע	ugerke	ugerke	ugerke
אויג	oyg	oyg	oyg
אויגאַנעס	oyganes	oyganes	oyganes
אויגוסט	oygust	oygust	oygust
אויגן־לעדל	oygn-ledl	oygn-ledl	oygn-ledl
אויגן־לעפּל	oygn-lepl	oygn-lepl	oygn-lepl
אויגנבליק	oygnblik	oygnblik	oygnblyk
אויגנלעדל	oygnledl	oygnledl	oygnledl
אויגנלעפּל	oygnlepl	oygnlepl	oygnlepl
אויגענעס	oygenes	oygenes	oygenes
אויגעפּל	oygepl	oygepl	oygepl
אויװן	oyvn	oyvn	oyvn
אויטאָ	oyto	oyto	oyto
אויטאָביאָגראַפֿיע	oytobiografye	oytobyografye	oytobyografye
אויטאָמאָביל	oytomobil	oytomobil	oytomobyl
אויטאָמאַט	oytomat	oytomat	oytomat
אויטאָנאָמיע	oytonomye	oytonomye	oytonomye
אויטאָר	oytor	oytor	oytor
אויסהערער	oysherer	oysherer	oysherer
אויסטער	oyster	oyster	oyster
אויסלײג	oysleyg	oysleyg	oyslyyg
אויסשטעלונג	oysshtelung	oysshtelung	oysshtelung
אויער	oyer	oyer	oyer
אויפֿרוף	oyfruf	oyfruf	oyfruf
אויפֿשטאַנד	oyfshtand	oyfshtand	oyfshtand
אומברענג־לאַגער	umbreng-lager	umbreng-lager	umbreng-lager
אונגאַריש	ungarish	ungarish	ungarysh
אונגער	unger	unger	unger
אונגעריש	ungerish	ungerish	ungerysh
אונטערגאַנג	untergang	untergang	untergang
אונטערגרונט	untergrunt	untergrunt	untergrunt
אונטערמענטש	untermentsh	untermentsh	untermentsh
אונטערנעמונג	unternemung	unternemung	unternemung
אונטערשיד	untershid	untershid	untershyd
אונטערשײד	untersheyd	untersheyd	untershyyd
אוניװערס	univers	univers	unyvers
אוניװערסיטעט	universitet	universitet	unyversytet
אופֿן	oyfn	oyfn	ufn
אוצר	oytser	oytser	utsr
אוקראַיִניש	ukrainish	ukrainish	ukrainysh
אוקראַיִנער	ukrainer	ukrainer	ukrainer
אור־אײניקל	ur-eynikl	ur-eynikl	ur-ayynykl
אור־באָבע	ur-bobe	ur-bobe	ur-bobe
אוראַנוס	uranus	uranus	uranus
אוראַניום	uranyum	uranyum	uranyum
אורעלטערן	ureltern	ureltern	ureltern
אות	os	os	us
אחד	ekhod	ekhod	achd
אחרון	akhren	khrun	achrun
אחריות	akhrayes	khryus	achryus
איבערזעצונג	iberzetsung	iberzetsung	yberzetsung
איבערזעצער	iberzetser	iberzetser	yberzetser
איבערמענטש	ibermentsh	ibermentsh	ybermentsh
אידיאָט	idyot	idyot	ydyot
אידיליע	idilye	idilye	ydylye
אידעאָלאָגיע	ideologye	ideologye	ydeologye
אידענטיטעט	identitet	identitet	ydentytet
איטאַליענער	italyener	italyener	ytalyener
אײ	ey	ey	ayy
אײגנטום	eygntum	eygntum	ayygntum
אײזל	eyzl	eyzl	ayyzl
אײכנבוים	eykhnboym	eykhnboym	ayychnboym
אײל	eyl	eyl	ayyl
אײניקל	eynikl	eynikl	ayynykl
אײנצאָל	eyntsol	eyntsol	ayyntsol
אײעלע	eyele	eyele	ayyele
אײר	iyer	ier	ayyr
אײראָפּעיִש	eyropeish	eyropeish	ayyropeish
אײראָפּעער	eyropeer	eyropeer	ayyropeer
אײראָפּעערין	eyropeerin	eyropeerin	ayyropeeryn
אימאַם	imam	imam	ymam
אימיגראַנט	imigrant	imigrant	ymygrant
אימיגראַציע	imigratsye	imigratsye	ymygratsye
אינגבער	ingber	ingber	yngber
אינד	ind	ind	ynd
אינדזל	indzl	indzl	yndzl
אינדיק	indik	indik	yndyk
אינהאַלט	inhalt	inhalt	ynhalt
אינזל	inzl	inzl	ynzl
אינזשעניר	inzhenir	inzhenir	ynzhenyr
אינזשעניריע	inzhenirye	inzhenirye	ynzhenyrye
אינזשענער	inzhener	inzhener	ynzhener
אינזשענעריע	inzhenerye	inzhenerye	ynzhenerye
אינטערנעט	internet	internet	ynternet
אינטערנעץ	internets	internets	ynternets
איניציאַטיװ	initsyativ	initsyativ	ynytsyatyv
אינסטיטוט	institut	institut	ynstytut
אינפֿיניטיװ	infinitiv	infinitiv	ynfynytyv
אינפֿלאַציע	inflatsye	inflatsye	ynflatsye
איסאָמער	isomer	isomer	ysomer
איסור	iser	iser	ysur
איסלאַם	islam	islam	yslam
איסלאַמיסט	islamist	islamist	yslamyst
איסלאַמער	islamer	islamer	yslamer
אירלענדער	irlender	irlender	yrlender
אירע	ire	ire	yre
אלול	elel	elel	alul
אלף	alef	elef	alf
אלף־בית	alef-beys	lf-bis	alf-bys
אמונה	emune	emune	amunh
אמורא	amoyre	mur	amura
אמת	emes	emes	ams
אפיקומן	afikoymen	alefפikumn	afykumn
ארון	orn	run	arun
אתרוג	esreg	esreg	asrug
אײַז	ayz	ayz	aayz
אײַזן	ayzn	ayzn	aayzn
אײַזנבאַן	ayznban	ayznban	aayznban
אײַזנגעשעפֿט	ayzngesheft	ayzngesheft	aayzngesheft
אײַזקרעם	ayzkrem	ayzkrem	aayzkrem
אײַראָפּלאַן	ayroplan	ayroplan	aayroplan
באָב	bob	bob	bob
באָבע	bobe	bobe	bobe
באָבע־זײדע	bobe-zeyde	bobe-zeyde	bobe-zyyde
באָבע־מעשׂה	bobe-mayse	bobe-mesh	bobe-mesh
באַגאַזש	bagazh	bagazh	bagazh
באַגינען	baginen	baginen	bagynen
באַגעגעניש	bagegenish	bagegenish	bagegenysh
באַגער	bager	bager	bager
באַגריף	bagrif	bagrif	bagryf
באַגרעבער	bagreber	bagreber	bagreber
באָד	bod	bod	bod
באַדאַרף	badarf	badarf	badarf
באָדהיטל	bodhitl	bodhitl	bodhytl
באַדעקנס	badekns	badekns	badekns
באָדקאָסטום	bodkostum	bodkostum	bodkostum
באַדײַטונג	badaytung	badaytung	badaytung
באַהן	bahn	bahn	bahn
באַװעגונג	bavegung	bavegung	bavegung
באַזאַלט	bazalt	bazalt	bazalt
באַזוך	bazukh	bazukh	bazuch
באַזוכער	bazukher	bazukher	bazucher
באַטיושקע	batyushke	batyushke	batyushke
באָיאַרין	boyarin	boyarin	boyaryn
באַל	bal	bal	bal
באַלאַגאַן	balagan	balagan	balagan
באַלאַד	balad	balad	balad
באַלאַדע	balade	balade	balade
באַלאַלײַקע	balalayke	balalayke	balalayke
באַלן	baln	baln	baln
באַלעבאָס	balebos	balebos	balebos
באַלעבאָסטע	baleboste	baleboste	baleboste
באַלעם	balem	balem	balem
באָלשעװיזם	bolshevizm	bolshevizm	bolshevyzm
באָלשעװיסט	bolshevist	bolshevist	bolshevyst
באָלשעװיק	bolshevik	bolshevik	bolshevyk
באַן	ban	ban	ban
באַנאַנע	banane	banane	banane
באַנדזשאָ	bandzho	bandzho	bandzho
באַנק	bank	bank	bank
באַנק־קװעטשער	bank-kvetsher	bank-kvetsher	bank-kvetsher
באַנקבעטל	bankbetl	bankbetl	bankbetl
באַנקיר	bankir	bankir	bankyr
באַנקירער	bankirer	bankirer	bankyrer
באַס	bas	bas	bas
באָסניאַק	bosnyak	bosnyak	bosnyak
באַסקעטבאָל	basketbol	basketbol	basketbol
באַפּטיסט	baptist	baptist	baptyst
באַפֿעלקערונג	bafelkerung	bafelkerung	bafelkerung
באַפֿרײַונג	bafrayung	bafrayung	bafrayung
באַפֿרײַער	bafrayer	bafrayer	bafrayer
באַק	bak	bak	bak
באַקטעריאָלאָגיע	bakteryologye	bakteryologye	bakteryologye
באַר	bar	bar	bar
באַראָן	baron	baron	baron
באַרג	barg	barg	barg
באָרד	bord	bord	bord
באָרדער	border	border	border
באָרשט	borsht	borsht	borsht
באַשאַפֿונג	bashafung	bashafung	bashafung
באַשאַפֿער	bashafer	bashafer	bashafer
באַשלוס	bashlus	bashlus	bashlus
באַשעפֿער	bashefer	bashefer	bashefer
בבֿלי	bovli	bavli	bvly
בגד	beged	beged	bgd
בדחן	badkhn	badkhn	bdchn
בהלה	behole	behole	bhlh
בהמה	beheyme	beheyme	bhmh
בובע	bube	bube	bube
בובעלע	bubele	bubele	bubele
בודהיזם	budhizm	budhizm	budhyzm
בודהיסט	budhist	budhist	budhyst
בוהײ	buhay	buhey	buhyy
בוהײַ	buhay	buhay	buhay
בויגן	boygn	boygn	boygn
בויגן־שיסער	boygn-shiser	boygn-shiser	boygn-shyser
בויטשיק	boytshik	boytshik	boytshyk
בויטשיקל	boytshikl	boytshikl	boytshykl
בויך	boykh	boykh	boych
בויכרעדער	boykhreder	boykhreder	boychreder
בוים	boym	boym	boym
בוך	bukh	bukh	buch
בולבע	bulbe	bulbe	bulbe
בולגאַריש	bulgarish	bulgarish	bulgarysh
בוקסיר	buksir	buksir	buksyr
בור	bur	bur	bur
בורא	boyre	boyre	bura
בורג	burg	burg	burg
בוריק	burik	burik	buryk
בחור	bokher	bokher	bchur
ביאָגראַפֿיע	byografye	byografye	byografye
ביאָכעמיע	byokhemye	byokhemye	byochemye
ביאַלי	bialy	byali	byaly
ביבליאָטעק	biblyotek	biblyotek	byblyotek
ביבליאָטעקער	biblyoteker	biblyoteker	byblyoteker
ביבליאָטעקעראין	biblyotekerin	biblyotekerin	byblyotekeryn
ביבער	biber	biber	byber
ביוראָ	byuro	byuro	byuro
ביוראָקראַט	byurokrat	byurokrat	byurokrat
ביוראָקראַטיע	byurokratye	byurokratye	byurokratye
ביט	bit	bit	byt
בײגונג	beygung	beygung	byygung
בײגל	beygl	beygl	byygl
בײגעלע	beygele	beygele	byygele
בײמל	beyml	beyml	byyml
בײן	beyn	beyn	byyn
ביכל	bikhl	bikhl	bychl
ביכערקראָם	bikherkrom	bikherkrom	bycherkrom
בילד	bild	bild	byld
בילדונג	bildung	bildung	byldung
ביליאָן	bilyon	bilyon	bylyon
בילעט	bilet	bilet	bylet
בימה	bime	bime	bymh
בימקום	bimkem	bimkem	bymkum
בין	bin	bin	byn
בינטל	bintl	bintl	byntl
ביס	bis	bis	bys
ביסל	bisl	bisl	bysl
ביסקופּ	biskup	biskup	byskup
ביצה	beytse	beytse	bytsh
ביציקל	bitsikl	bitsikl	bytsykl
ביציקלעט	bitsiklet	bitsiklet	bytsyklet
ביק	bik	bik	byk
ביקס	biks	biks	byks
ביר	bir	bir	byr
בירגער	birger	birger	byrger
בישאָף	bishof	bishof	byshof
בית	beys	beyz	bys
בית־דין	beyz-din	bezdn	bys-dyn
בית־עולם	beys-oylem	besoylem	bys-eulm
בכור	bkhor	bkhor	bchur
בכורה	bkhoyre	bkhoyre	bchurh
בלאָז	bloz	bloz	bloz
בלאַט	blat	blat	blat
בלאָטע	blote	blote	blote
בלאָק	blok	blok	blok
בלוט	blut	blut	blut
בלוטבאָד	blutbod	blutbod	blutbod
בלום	blum	blum	blum
בלומענטאָפּ	blumentop	blumentop	blumentop
בלי	bli	bli	bly
בלינצע	blintse	blintse	blyntse
בליץ	blits	blits	blyts
בליצבריװ	blitsbriv	blitsbriv	blytsbryv
בליצבריװל	blitsbrivl	blitsbrivl	blytsbryvl
בליצפּאָסט	blitspost	blitspost	blytspost
בליצשלעסל	blitsshlesl	blitsshlesl	blytsshlesl
בלעטל	bletl	bletl	bletl
בלעך	blekh	blekh	blech
בלעכער	blekher	blekher	blecher
בלײַ	blay	blay	blay
בלײַער	blayer	blayer	blayer
במקום	bimkem	bmkum	bmkum
בן־מלך	ben-meylekh	benmeylekh	bn-mlch
בנים	bonem	bonim	bnym
בעבל	bebl	bebl	bebl
בעזעם	bezem	bezem	bezem
בעט	bet	bet	bet
בעכער	bekher	bekher	becher
בעל־הבית	balebos	balebos	bel-hbys
בעל־הביתטע	baleboste	baleboste	bel-hbyste
בעל־מלאָכה	balmelokhe	balmelokhe	bel-mlochh
בענטשליכט	bentshlikht	bentshlikht	bentshlycht
בענקל	benkl	benkl	benkl
בעסאַראַבער	besaraber	besaraber	besaraber
בעקישע	bekishe	bekishe	bekyshe
בעקער	beker	beker	beker
בעקערײַ	bekeray	bekeray	bekeray
בעקעשע	bekeshe	bekeshe	bekeshe
בער	ber	ber	ber
בעריאָזע	beryoze	beryoze	beryoze
בעריליום	berilyum	berilyum	berylyum
בערעזע	bereze	bereze	bereze
בקשה	bakoshe	bakoshe	bkshh
בראָדער	broder	broder	broder
בראָך	brokh	brokh	broch
בראָנדז	brondz	brondz	brondz
בראָנפֿן	bronfn	bronfn	bronfn
בראָנקסער	bronkser	bronkser	bronkser
בראשית	breyshes	breyshes	brashys
ברודער	bruder	bruder	bruder
ברודערשאַפֿט	brudershaft	brudershaft	brudershaft
ברויז	broyz	broyz	broyz
ברויט	broyt	broyt	broyt
ברויטניצע	broytnitse	broytnitse	broytnytse
ברונעט	brunet	brunet	brunet
ברונעם	brunem	brunem	brunem
ברוסט	brust	brust	brust
ברוסטקאַסטן	brustkastn	brustkastn	brustkastn
ברוקלינער	brukliner	brukliner	bruklyner
בריאה	brie	brie	bryah
ברידערשאַפֿט	bridershaft	bridershaft	brydershaft
בריװ	briv	briv	bryv
ברײט	breyt	breyt	bryyt
ברײטל	breytl	breytl	bryytl
ברילן	briln	briln	bryln
בריק	brik	brik	bryk
בריקל	brikl	brikl	brykl
ברירה	breyre	breyre	bryrh
ברית	bris	bris	brys
ברכה	brokhe	brokhe	brchh
ברעג	breg	breg	breg
ברעט	bret	bret	bret
ברעטל	bretl	bretl	bretl
ברעם	brem	brem	brem
ברענהאָלץ	brenholts	brenholts	brenholts
ברײַ	bray	bray	bray
בשׂמים	besomem	bsomim	bsmym
בת־מלכּה	bas-malke	basmalke	bs-mlkh
בת־קול	bas-kol	bs-kul	bs-kul
בתולה	bsule	psule	bsulh
בײַטש	baytsh	baytsh	baytsh
בײַכל	baykhl	baykhl	baychl
בײַשפּיל	bayshpil	bayshpil	bayshpyl
גאָב	gob	gob	gob
גאָון	goen	goen	goun
גאָט	got	got	got
גאָטעניו	gotenyu	gotenyu	gotenyu
גאַל	gal	gal	gal
גאַלאָן	galon	galon	galon
גאָלד	gold	gold	gold
גאָלדשמיד	goldshmid	goldshmid	goldshmyd
גאַליציאַנער	galitsyaner	galitsyaner	galytsyaner
גאַליציאַנערין	galitsyanerin	galitsyanerin	galytsyaneryn
גאָלמעסער	golmeser	golmeser	golmeser
גאָלמעסערל	golmeserl	golmeserl	golmeserl
גאָלקרעם	golkrem	golkrem	golkrem
גאָמבע	gombe	gombe	gombe
גאָמלקע	gomlke	gomlke	gomlke
גאָנדאָלע	gondole	gondole	gondole
גאַנדז	gandz	gandz	gandz
גאַנז	ganz	ganz	ganz
גאַס	gas	gas	gas
גאַסט	gast	gast	gast
גאָפּל	gopl	gopl	gopl
גאָפּל־לעפֿל	gopl-lefl	gopl-lefl	gopl-lefl
גאַרב	garb	garb	garb
גאַרבער	garber	garber	garber
גאַרבערײַ	garberay	garberay	garberay
גאָרטן	gortn	gortn	gortn
גאָרטשיצע	gortshitse	gortshitse	gortshytse
גאָרילע	gorile	gorile	goryle
גאון	goen	gun	gun
גבֿורה	gvure	gvure	gvurh
גבאי	gabe	gabe	gby
גבאיטע	gabete	gabete	gbyte
גבור	giber	gbur	gbur
גװאַלד	gvald	gvald	gvald
גװאַלט	gvalt	gvalt	gvalt
גוטמאַכונג	gutmakhung	gutmakhung	gutmachung
גוי	goy	goy	goy
גולאַג	gulag	gulag	gulag
גולאַש	gulash	gulash	gulash
גולם	goylem	goylem	gulm
גומע	gume	gume	gume
גוף	guf	guf	guf
גורל	goyrl	goyrl	gurl
גזלן	gazlen	gazlen	gzln
גזשיװע	gzhive	gzhive	gzhyve
גזשיװקע	gzhivke	gzhivke	gzhyvke
גיבור	giber	giber	gybur
גיטאַר	gitar	gitar	gytar
גיך	gikh	gikh	gych
גימל	giml	giml	gyml
גימנאַזיע	gimnazye	gimnazye	gymnazye
גיפֿט	gift	gift	gyft
גלאָבאַליזאַציע	globalizatsye	globalizatsye	globalyzatsye
גלאָבוס	globus	globus	globus
גלאָז	gloz	gloz	gloz
גלאָק	glok	glok	glok
גלוסט	glust	glust	glust
גלות	goles	goles	glus
גלח	galekh	galekh	glch
גליטש	glitsh	glitsh	glytsh
גליק	glik	glik	glyk
גלײַכונג	glaykhung	glaykhung	glaychung
גן	gan	gn	gn
גנב	ganef	gnb	gnb
גנבֿ	ganef	ganev	gnv
גנבֿה	gnéyve	ganeyve	gnvh
געאָגראַפֿיע	geografye	geografye	geografye
געאָלאָג	geolog	geolog	geolog
געאָלאָגיע	geologye	geologye	geologye
געאָמעטריע	geometrye	geometrye	geometrye
געבוירן־טאָג	geboyrn-tog	geboyrn-tog	geboyrn-tog
געבוירנטאָג	geboyrntog	geboyrntog	geboyrntog
געבורטסטאָג	geburtstog	geburtstog	geburtstog
געבורצטאָג	geburtstog	geburtstog	geburtstog
געגנט	gegnt	gegnt	gegnt
געדאַנק	gedank	gedank	gedank
געדיכט	gedikht	gedikht	gedycht
געדערעם	gederem	gederem	gederem
געװאַלד	gevald	gevald	gevald
געװאַלט	gevalt	gevalt	gevalt
געװײן	geveyn	geveyn	gevyyn
געװיכט	gevikht	gevikht	gevycht
געװינס	gevins	gevins	gevyns
געװער	gever	gever	gever
געזאַנג	gezang	gezang	gezang
געזונט	gezunt	gezunt	gezunt
געזיכט	gezikht	gezikht	gezycht
געזעל	gezel	gezel	gezel
געזעלשאַפֿט	gezelshaft	gezelshaft	gezelshaft
געזעץ	gezets	gezets	gezets
געטאָ	geto	geto	geto
געטראַנק	getrank	getrank	getrank
געלט	gelt	gelt	gelt
גענדזל	gendzl	gendzl	gendzl
גענעטיק	genetik	genetik	genetyk
גענעראַל	general	general	general
געסל	gesl	gesl	gesl
געסקע	geske	geske	geske
געסרחה	gesrokhe	gesrokhe	gesrchh
געפֿיל	gefil	gefil	gefyl
גערויש	geroysh	geroysh	geroysh
גערטל	gertl	gertl	gertl
גערטנער	gertner	gertner	gertner
גערטנערײַ	gertneray	gertneray	gertneray
גערמאַנעץ	germanets	germanets	germanets
גערשט	gersht	gersht	gersht
געשאַנק	geshank	geshank	geshank
געשװיר	geshvir	geshvir	geshvyr
געשטאַלט	geshtalt	geshtalt	geshtalt
געשיכטע	geshikhte	geshikhte	geshychte
געשמאַק	geshmak	geshmak	geshmak
געשעפֿט	gesheft	gesheft	gesheft
געשעפֿטסמאַן	gesheftsman	gesheftsman	gesheftsman
געשפּרעך	geshprekh	geshprekh	geshprech
גראָבאײַזן	grobayzn	grobayzn	grobaayzn
גראַגער	grager	grager	grager
גראָז	groz	groz	groz
גראַם	gram	gram	gram
גראַמאַטיק	gramatik	gramatik	gramatyk
גראַניט	granit	granit	granyt
גראַף	graf	graf	graf
גראַפֿיט	grafit	grafit	grafyt
גראַפֿין	grafin	grafin	grafyn
גראַפֿיניע	grafinye	grafinye	grafynye
גראָשן	groshn	groshn	groshn
גרוזיניש	gruzinish	gruzinish	gruzynysh
גרוזינער	gruziner	gruziner	gruzyner
גרויל	groyl	groyl	groyl
גרויסקײט	groyskeyt	groyskeyt	groyskyyt
גרונט	grunt	grunt	grunt
גרופּע	grupe	grupe	grupe
גריבענעס	gribenes	gribenes	grybenes
גריװע	grive	grive	gryve
גריװקע	grivke	grivke	gryvke
גרײפּפֿרוט	greypfrut	greypfrut	gryypfrut
גרײפּפֿרוכט	greypfrukht	greypfrukht	gryypfrucht
גריך	grikh	grikh	grych
גריכיש	grikhish	grikhish	grychysh
גרינדער	grinder	grinder	grynder
גרינס	grins	grins	gryns
גריף	grif	grif	gryf
גרעבער	greber	greber	greber
גרעט	gret	gret	gret
גרענעץ	grenets	grenets	grenets
גרײַז	grayz	grayz	grayz
גשמיות	gashmies	gashmies	gshmyus
גײַסט	gayst	gayst	gayst
דאַטע	date	date	date
דאַטשע	datshe	datshe	datshe
דאַך	dakh	dakh	dach
דאָלאַר	dolar	dolar	dolar
דאַמקע	damke	damke	damke
דאָנערשטיק	donershtik	donershtik	donershtyk
דאַנקבאַרקײט	dankbarkeyt	dankbarkeyt	dankbarkyyt
דאָקומענט	dokument	dokument	dokument
דאָקטאָר	doktor	doktor	doktor
דאָקטער	dokter	dokter	dokter
דאָקטערײַ	dokteray	dokteray	dokteray
דאַקס	daks	daks	daks
דאָרף	dorf	dorf	dorf
דאָרפֿמאַן	dorfman	dorfman	dorfman
דאָרשט	dorsht	dorsht	dorsht
דװאָריאַנין	dvoryanin	dvoryanin	dvoryanyn
דװאָרעץ	dvorets	dvorets	dvorets
דור	dor	dor	dur
דזשאַז	dzhaz	dzhaz	dzhaz
דזשוכע	dzhukhe	dzhukhe	dzhuche
דזשיראַף	dzhiraf	dzhiraf	dzhyraf
דזשעז	dzshez	dzhez	dzhez
דזשעיל	dzheyl	dzheil	dzheyl
דיאַדעמע	dyademe	dyademe	dyademe
דיאַלעקט	dyalekt	dyalekt	dyalekt
דיאַלעקטאָלאָגיע	dyalektologye	dyalektologye	dyalektologye
דיבוק	dibek	dibek	dybuk
דיװידענד	dividend	dividend	dyvydend
דײן	dayen	dayen	dyyn
דיך	dikh	dikh	dych
דיכטונג	dikhtung	dikhtung	dychtung
דיכטער	dikhter	dikhter	dychter
דיל	dil	dil	dyl
דימענט	diment	diment	dyment
דין	din	din	dyn
דינאָזאַװער	dinozaver	dinozaver	dynozaver
דינאַסטיע	dinastye	dinastye	dynastye
דיניע	dinye	dinye	dynye
דינסט	dinst	dinst	dynst
דינסטאָג	dinstog	dinstog	dynstog
דינסטיק	dinstik	dinstik	dynstyk
דינסטמויד	dinstmoyd	dinstmoyd	dynstmoyd
דינקע	dinke	dinke	dynke
דיסקאָטעק	diskotek	diskotek	dyskotek
דיסקרימינאַציע	diskriminatsye	diskriminatsye	dyskrymynatsye
דיקדוק	dikdek	dikdek	dykduk
דירה	dire	dire	dyrh
דירה־געלט	dire-gelt	dirh-gelt	dyrh-gelt
דלאָניע	dlonye	dlonye	dlonye
דעלפֿין	delfin	delfin	delfyn
דעמאָגראַפֿיע	demografye	demografye	demografye
דעמאָקראַציע	demokratsye	demokratsye	demokratsye
דעמב	demb	demb	demb
דעניש	denish	denish	denysh
דענקער	denker	denker	denker
דעצעמבער	detsember	detsember	detsember
דעקלאַראַציע	deklaratsye	deklaratsye	deklaratsye
דעקלינאַציע	deklinatsye	deklinatsye	deklynatsye
דערנערונג	dernerung	dernerung	dernerung
דערפֿל	derfl	derfl	derfl
דערקלערונג	derklerung	derklerung	derklerung
דראַמאַטורג	dramaturg	dramaturg	dramaturg
דראַמאַטורגיע	dramaturgye	dramaturgye	dramaturgye
דראַמע	drame	drame	drame
דראַקאָן	drakon	drakon	drakon
דרום	dorem	dorem	drum
דרוקער	druker	druker	druker
דרוקערײַ	drukeray	drukeray	drukeray
דריטל	dritl	dritl	drytl
דרײדל	dreydl	dreydl	dryydl
דרעק	drek	drek	drek
דרײַסיקסטל	draysikstl	draysikstl	draysykstl
דרײַעק	drayek	drayek	drayek
דרײַצנטל	draytsntl	draytsntl	draytsntl
דײַטש	daytsh	daytsh	daytsh
דײַטשמעריזם	daytshmerizm	daytshmerizm	daytshmeryzm
האָב	hob	hob	hob
האַביכט	habikht	habikht	habycht
האָבער	hober	hober	hober
האָבערין	hoberin	hoberin	hoberyn
האַװן	havn	havn	havn
האָז	hoz	hoz	hoz
האָטעל	hotel	hotel	hotel
האַלדז	haldz	haldz	haldz
האָלעפּצעס	holeptses	holeptses	holeptses
האָלץ	holts	holts	holts
האָמאָסעקסואַלוטעט	homoseksualutet	homoseksualutet	homoseksualutet
האַמער	hamer	hamer	hamer
האָן	hon	hon	hon
האַנדלער	handler	handler	handler
האַנט	hant	hant	hant
האַנטבוך	hantbukh	hantbukh	hantbuch
האַנטפֿלאַך	hantflakh	hantflakh	hantflach
האָניק	honik	honik	honyk
האָניקטײגל	honikteygl	honikteygl	honyktyygl
האַס	has	has	has
האָפֿענונג	hofenung	hofenung	hofenung
האַק	hak	hak	hak
האַקפֿלײש	hakfleysh	hakfleysh	hakflyysh
האָר	hor	hor	hor
האַרבסט	harbst	harbst	harbst
האָרן	horn	horn	horn
האָרע	hore	hore	hore
האַרף	harf	harf	harf
האַרפֿע	harfe	harfe	harfe
האַרץ	harts	harts	harts
הארץ	harts	hrts	harts
הבֿדלה	havdole	havdole	hvdlh
הוט	hut	hut	hut
הויז	hoyz	hoyz	hoyz
הויזן	hoyzn	hoyzn	hoyzn
הויט	hoyt	hoyt	hoyt
הויכדײַטש	hoykhdaytsh	hoykhdaytsh	hoychdaytsh
הויפּטל	hoyptl	hoyptl	hoyptl
הויפּטשטאָט	hoyptshtot	hoyptshtot	hoyptshtot
הוליגאַן	huligan	huligan	hulygan
הומאָר	humor	humor	humor
הומאָריסט	humorist	humorist	humoryst
הון	hun	hun	hun
הונגער	hunger	hunger	hunger
הונדערטסטל	hundertstl	hundertstl	hundertstl
הונט	hunt	hunt	hunt
הורה	hore	hurh	hurh
הידראָגען	hidrogen	hidrogen	hydrogen
היטל	hitl	hitl	hytl
הײ	hey	hey	hyy
הײבמוטער	heybmuter	heybmuter	hyybmuter
הײװן	heyvn	heyvn	hyyvn
הײך	heykh	heykh	hyych
הײל	heyl	heyl	hyyl
הײם	heym	heym	hyym
הײמאַרבעט	heymarbet	heymarbet	hyymarbet
הײמלאַנד	heymland	heymland	hyymland
הײמשטאָט	heymshtot	heymshtot	hyymshtot
הײראַט	heyrat	heyrat	hyyrat
הײשעריק	heysherik	heysherik	hyysheryk
הילף	hilf	hilf	hylf
הילפֿסװערב	hilfsverb	hilfsverb	hylfsverb
הימל	himl	himl	hyml
הימנע	himne	himne	hymne
הינדל	hindl	hindl	hyndl
הינטעלע	hintele	hintele	hyntele
הינטערגעסל	hintergesl	hintergesl	hyntergesl
היסטאָריע	historye	historye	hystorye
הירזש	hirzh	hirzh	hyrzh
הירש	hirsh	hirsh	hyrsh
הלכה	halokhe	halokhe	hlchh
המן־טאַש	homen-tash	homentash	hmn-tash
המן־טאַשן	homen-tashn	hmn-tashn	hmn-tashn
העברעיש	hebreish	hebreish	hebreysh
העברעיִש	hebreish	hebreish	hebreish
העלד	held	held	held
העלדזל	heldzl	heldzl	heldzl
העלדין	heldin	heldin	heldyn
העליום	helyum	helyum	helyum
העלפֿאַנד	helfand	helfand	helfand
העלפֿאַנט	helfant	helfant	helfant
העלפֿט	helft	helft	helft
העלפֿער	helfer	helfer	helfer
העלפֿערין	helferin	helferin	helferyn
העמד	hemd	hemd	hemd
הענדלער	hendler	hendler	hendler
הענטשקע	hentshke	hentshke	hentshke
העפֿט	heft	heft	heft
העקל	hekl	hekl	hekl
הער	her	her	her
הערב	herb	herb	herb
הערינג	hering	hering	heryng
הערצאָג	hertsog	hertsog	hertsog
הפֿטרה	haftore	hftrh	hftrh
הצלחה	hatslokhe	hatslokhe	htslchh
הקדמה	hakdome	hagdome	hkdmh
הרבֿ	horov	horav	hrv
הריגה	harige	harige	hrygh
השׂכּלה	haskole	haskole	hsklh
הײַזל	hayzl	hayzl	hayzl
הײַזקע	hayzke	hayzke	hayzke
הײַסקול	hayskul	hayskul	hayskul
הײַפֿיש	hayfish	hayfish	hayfysh
ה׳	h'	hey׳	h׳
װאָג	vog	vog	vog
װאַגאָן	vagon	vagon	vagon
װאַגינע	vagine	vagine	vagyne
װאָגן	vogn	vogn	vogn
װאָיעװאָדע	voyevode	voyevode	voyevode
װאַך	vakh	vakh	vach
װאָך	vokh	vokh	voch
װאַכנאַכט	vakhnakht	vakhnakht	vachnacht
װאָכנבלאַט	vokhnblat	vokhnblat	vochnblat
װאַלד	vald	vald	vald
װאָלף	volf	volf	volf
װאַלפֿיש	valfish	valfish	valfysh
װאָלקן	volkn	volkn	volkn
װאַמפּיר	vampir	vampir	vampyr
װאַנט	vant	vant	vant
װאַנילע	vanile	vanile	vanyle
װאַנע	vane	vane	vane
װאַנץ	vants	vants	vants
װאָנצעס	vontses	vontses	vontses
װאַסער	vaser	vaser	vaser
װאַסערשטאָף	vasershtof	vasershtof	vasershtof
װאָפֿן	vofn	vofn	vofn
װאַקאַציע	vakatsye	vakatsye	vakatsye
װאַקוּום	vakuum	vakuum	vakuum
װאָר	vor	vor	vor
װאָרט	vort	vort	vort
װאַרנישקעס	varnishkes	varnishkes	varnyshkes
װאָרעם	vorem	vorem	vorem
װאַרעמקײט	varemkeyt	varemkeyt	varemkyyt
װאָרצל	vortsl	vortsl	vortsl
װאַרשעװער	varshever	varshever	varshever
װאַשצימער	vashtsimer	vashtsimer	vashtsymer
װאסער	vaser	vser	vaser
װוּנד	vund	vund	vund
װוּנדער	vunder	vunder	vunder
װוּרשט	vursht	vursht	vursht
װוּרשטל	vurshtl	vurshtl	vurshtl
װוינונג	voynung	voynung	voynung
װוינצימער	voyntsimer	voyntsimer	voyntsymer
װיאָלע	vyole	vyole	vyole
װיאָסלע	vyosle	vyosle	vyosle
װיאָרסט	vyorst	vyorst	vyorst
װיג	vig	vig	vyg
װיגל	vigl	vigl	vygl
װיגליד	viglid	viglid	vyglyd
װיגעלע	vigele	vigele	vygele
װידער	vider	vider	vyder
װידערגוטמאַכונג	vidergutmakhung	vidergutmakhung	vydergutmachung
װיזע	vize	vize	vyze
װײ	vey	vey	vyy
װײדל	veydl	veydl	vyydl
װײן	vayn	veyn	vyyn
װײץ	veyts	veyts	vyyts
װינדל	vindl	vindl	vyndl
װינט	vint	vint	vynt
װינטער	vinter	vinter	vynter
װינטערצײַט	vintertsayt	vintertsayt	vyntertsayt
װיסן	visn	visn	vysn
װיסנשאַפֿט	visnshaft	visnshaft	vysnshaft
װיסנשאַפֿטלער	visnshaftler	visnshaftler	vysnshaftler
װיסקײ	viskey	viskey	vyskyy
װיִע	vie	vie	vie
װיץ	vits	vits	vyts
װירוס	virus	virus	vyrus
װעב	veb	veb	veb
װעבזײַטל	vebzaytl	vebzaytl	vebzaytl
װעג	veg	veg	veg
װעגעטאַריער	vegetaryer	vegetaryer	vegetaryer
װעט	vet	vet	vet
װעט־זײַט	vet-zayt	vet-zayt	vet-zayt
װעטער	veter	veter	veter
װעלאָסיפּעד	velosiped	velosiped	velosyped
װעלט	velt	velt	velt
װעלט־מלחמה	velt-milkhome	velt-mlkhmh	velt-mlchmh
װעלטײל	velteyl	velteyl	veltyyl
װעלטסװערטל	veltsvertl	veltsvertl	veltsvertl
װעלטסמענטש	veltsmentsh	veltsmentsh	veltsmentsh
װענגער	venger	venger	venger
װענוס	venus	venus	venus
װעסלע	vesle	vesle	vesle
װערב	verb	verb	verb
װערבע	verbe	verbe	verbe
װערט	vert	vert	vert
װערטל	vertl	vertl	vertl
װערטעלע	vertele	vertele	vertele
װערטערבוך	verterbukh	verterbukh	verterbuch
װערטערקלאַס	verterklas	verterklas	verterklas
װערסט	verst	verst	verst
װערק	verk	verk	verk
װעש	vesh	vesh	vesh
װעשער	vesher	vesher	vesher
װעשערין	vesherin	vesherin	vesheryn
װײַב	vayb	vayb	vayb
װײַבל	vaybl	vaybl	vaybl
װײַבערשול	vaybershul	vaybershul	vaybershul
װײַלע	vayle	vayle	vayle
װײַן	vayn	vayn	vayn
װײַנגאָרטן	vayngortn	vayngortn	vayngortn
װײַנטרויב	vayntroyb	vayntroyb	vayntroyb
װײַנשל	vaynshl	vaynshl	vaynshl
װײַנשלבוים	vaynshlboym	vaynshlboym	vaynshlboym
װײַספֿיש	vaysfish	vaysfish	vaysfysh
װײַסרוסיש	vaysrusish	vaysrusish	vaysrusysh
זאָאָלאָגיע	zoologye	zoologye	zoologye
זאָגער	zoger	zoger	zoger
זאָגערין	zogerin	zogerin	zogeryn
זאָגערקע	zogerke	zogerke	zogerke
זאַװערוכע	zaverukhe	zaverukhe	zaveruche
זאָטל	zotl	zotl	zotl
זאָטלער	zotler	zotler	zotler
זאַך	zakh	zakh	zach
זאַלב	zalb	zalb	zalb
זאַלץ	zalts	zalts	zalts
זאַמד	zamd	zamd	zamd
זאַמלבוך	zamlbukh	zamlbukh	zamlbuch
זאַמלער	zamler	zamler	zamler
זאַנג	zang	zang	zang
זאַפֿט	zaft	zaft	zaft
זאַק	zak	zak	zak
זאָק	zok	zok	zok
זאָרג	zorg	zorg	zorg
זויגלינג	zoygling	zoygling	zoyglyng
זויגער	zoyger	zoyger	zoyger
זוימען	zoymen	zoymen	zoymen
זויערקרויט	zoyerkroyt	zoyerkroyt	zoyerkroyt
זולו	zulu	zulu	zulu
זומער	zumer	zumer	zumer
זומער־פֿײגעלע	zumer-feygele	zumer-feygele	zumer-fyygele
זומערצײַט	zumertsayt	zumertsayt	zumertsayt
זומערקורס	zumerkurs	zumerkurs	zumerkurs
זון	zun	zun	zun
זון־אונטערגאַנג	zun-untergang	zun-untergang	zun-untergang
זונאויפֿגאַנג	zunoyfgang	zunoyfgang	zunoyfgang
זונה	zoyne	zoyne	zunh
זונטיק	zuntik	zuntik	zuntyk
זונפֿאַרגאַנג	zunfargang	zunfargang	zunfargang
זופּ	zup	zup	zup
זוקיני	zukini	zukini	zukyny
זיבעטל	zibetl	zibetl	zybetl
זיבעציקסטל	zibetsikstl	zibetsikstl	zybetsykstl
זיבעצנטל	zibetsntl	zibetsntl	zybetsntl
זיװג	ziveg	ziveg	zyvg
זײגער	zeyger	zeyger	zyyger
זײגערל	zeygerl	zeygerl	zyygerl
זײדע	zeyde	zeyde	zyyde
זײדע־באָבע	zeyde-bobe	zeyde-bobe	zyyde-bobe
זײף	zeyf	zeyf	zyyf
זילבער	zilber	zilber	zylber
זין	zin	zin	zyn
זינגליד	zinglid	zinglid	zynglyd
זינגער	zinger	zinger	zynger
זינגערין	zingerin	zingerin	zyngeryn
זינגערקע	zingerke	zingerke	zyngerke
זינד	zind	zind	zynd
זיסקײַט	ziskayt	ziskayt	zyskayt
זיצטרין	zitstrin	zitstrin	zytstryn
זיצפֿלײש	zitsfleysh	zitsfleysh	zytsflyysh
זיקאָרן	zikorn	zikorn	zykorn
זכּרון	zikorn	zikorn	zkrun
זלאָטע	zlote	zlote	zlote
זמר	zemer	zemer	zmr
זמרל	zemerl	zmrl	zmrl
זעברע	zebre	zebre	zebre
זעג	zeg	zeg	zeg
זעכציקסטל	zekhtsikstl	zekhtsikstl	zechtsykstl
זעכצנטל	zekhtsntl	zekhtsntl	zechtsntl
זעלנער	zelner	zelner	zelner
זעלצערװאַסער	zeltservaser	zeltservaser	zeltservaser
זענעפֿט	zeneft	zeneft	zeneft
זעקל	zekl	zekl	zekl
זעקסטל	zekstl	zekstl	zekstl
זקן	zokn	zokn	zkn
זשאַבע	zhabe	zhabe	zhabe
זשאַרגאָן	zhargon	zhargon	zhargon
זשוק	zhuk	zhuk	zhuk
זשורנאַל	zhurnal	zhurnal	zhurnal
זשורנאַליזם	zhurnalizm	zhurnalizm	zhurnalyzm
זשורנאַליסט	zhurnalist	zhurnalist	zhurnalyst
זשורנאַליסטיק	zhurnalistik	zhurnalistik	zhurnalystyk
זשיד	zhid	zhid	zhyd
זשיװעצע	zhivetse	zhivetse	zhyvetse
זשמעניע	zhmenye	zhmenye	zhmenye
זײַד	zayd	zayd	zayd
זײַט	zayt	zayt	zayt
חבֿר	khaver	khaver	chvr
חבֿרה	khevre	khevre	chvrh
חבֿרה־מאַן	khevreman	khevreman	chvrh-man
חבֿרהשאַפֿט	khevreshaft	khvrhshaft	chvrhshaft
חבֿרטע	khaverte	khaverte	chvrte
חבֿרשאַפֿט	khavershaft	khavershaft	chvrshaft
חדר	kheyder	kheyder	chdr
חודש	khoydesh	khoydesh	chudsh
חול המועד	kholemoyed	khul hmued	chul hmued
חומש	khumesh	khumesh	chumsh
חופּה	khupe	khupe	chuph
חוצפּה	khutspe	khutspe	chutsph
חורבן	khurbn	khurbm	churbn
חושך	khoyshekh	khoyshekh	chushch
חזיר	khazer	khazer	chzyr
חזירײַ	khazeray	khazeray	chzyray
חזן	khazn	khazn	chzn
חז״ל	khazal	khz״lamed	chz״l
חידוש	khidesh	khidesh	chydush
חיה	khaye	khaye	chyh
חײל	khayel	khail	chyyl
חײם	khayem	khaim	chyym
חילוק	khilek	khilek	chyluk
חינוך	khinekh	khinekh	chynuch
חיריק	khirek	khirek	chyryk
חכם	khokhem	khokhem	chchm
חכמה	khokhme	khokhme	chchmh
חלה	khale	khale	chlh
חלום	kholem	kholem	chlum
חמץ	khomets	khomets	chmts
חן	kheyn	kheyn	chn
חנוכּה	khaneke	khanike	chnukh
חסיד	khosid	khosid	chsyd
חסידות	khsides	khsides	chsydus
חסידיזם	khsidizm	khsidizm	chsydyzm
חסידל	khosidl	khosedl	chsydl
חסרון	khisorn	khesorn	chsrun
חפֿץ	kheyfets	kheyfets	chfts
חרוסת	kharoyses	kharoyses	chruss
חרם	kheyrem	kheyrem	chrm
חשבון	kheshbn	khezhbm	chshbun
חשװן	kheshvn	khezhvn	chshvn
חשק	kheyshek	kheyshek	chshk
חתונה	khasene	khasene	chsunh
חתימה	khsime	khsime	chsymh
חתן	khosn	khosn	chsn
חתן־כּלה	khosn-kale	khosnkale	chsn-klh
טאַבאַק	tabak	tabak	tabak
טאָג	tog	tog	tog
טאָג־בוך	tog-bukh	tog-bukh	tog-buch
טאָגבלאַט	togblat	togblat	togblat
טאָגצײַטונג	togtsaytung	togtsaytung	togtsaytung
טאָגשול	togshul	togshul	togshul
טאָװל	tovl	tovl	tovl
טאַטויִרונג	tatuirung	tatuirung	tatoyirung
טאַטע	tate	tate	tate
טאַטע־מאַמע	tate-mame	tate-mame	tate-mame
טאָכטער	tokhter	tokhter	tochter
טאָל	tol	tol	tol
טאָמאַט	tomat	tomat	tomat
טאַנטע	tante	tante	tante
טאַנץ	tants	tants	tants
טאָפּ	top	top	top
טאָפּאָגראַפֿיע	topografye	topografye	topografye
טאָפּיעל	topyel	topyel	topyel
טאָק	tok	tok	tok
טאַקטיק	taktik	taktik	taktyk
טאַקסי	taksi	taksi	taksy
טאַראַקאַן	tarakan	tarakan	tarakan
טאַש	tash	tash	tash
טאַשנגעלט	tashngelt	tashngelt	tashngelt
טבֿת	teyves	teyves	tvs
טויב	toyb	toyb	toyb
טויזנט	toyznt	toyznt	toyznt
טויזנטסטל	toyzntstl	toyzntstl	toyzntstl
טויט	toyt	toyt	toyt
טוך	tukh	tukh	tuch
טומל	tuml	tuml	tuml
טומלער	tumler	tumler	tumler
טונפֿיש	tunfish	tunfish	tunfysh
טורמע	turme	turme	turme
טורעם	turem	turem	turem
טיגער	tiger	tiger	tyger
טײ	tey	tey	tyy
טײג	teyg	teyg	tyyg
טײגל	teygl	teygl	tyygl
טײטל	teytl	teytl	tyytl
טײטלבוים	teytlboym	teytlboym	tyytlboym
טײל	teyl	teyl	tyyl
טיכל	tikhl	tikhl	tychl
טינט	tint	tint	tynt
טינטפֿיש	tintfish	tintfish	tyntfysh
טיפֿלע	tifle	tifle	tyfle
טיר	tir	tir	tyr
טיש	tish	tish	tysh
טלית	tales	tales	tlys
טעאַטער	teater	teater	teater
טעאָלאָגיע	teologye	teologye	teologye
טעאָריע	teorye	teorye	teorye
טעות	toes	toes	teus
טעכנאָלאָגיע	tekhnologye	tekhnologye	technologye
טעכניק	tekhnik	tekhnik	technyk
טעכניקער	tekhniker	tekhniker	technyker
טעלעגראַם	telegram	telegram	telegram
טעלעגראַמע	telegrame	telegrame	telegrame
טעלעגראַף	telegraf	telegraf	telegraf
טעלעװיזאָר	televizor	televizor	televyzor
טעלעװיזיע	televizye	televizye	televyzye
טעלעסקאָפּ	teleskop	teleskop	teleskop
טעלעפֿאָן	telefon	telefon	telefon
טעלער	teler	teler	teler
טעם	tam	tam	tem
טעמע	teme	teme	teme
טעמפּל	templ	templ	templ
טענענבוים	tenenboym	tenenboym	tenenboym
טענצל	tentsl	tentsl	tentsl
טענצער	tentser	tentser	tentser
טעפּער	teper	teper	teper
טעקל	tekl	tekl	tekl
טעריטאָריע	teritorye	teritorye	terytorye
טערמאָמעטער	termometer	termometer	termometer
טערק	terk	terk	terk
טערקלטויב	terkltoyb	terkltoyb	terkltoyb
טראָטואַר	trotuar	trotuar	trotuar
טראַכט	trakht	trakht	tracht
טראַף	traf	traf	traf
טראָפּ	trop	trop	trop
טראָפֿײ	trofey	trofey	trofyy
טראָצקיזם	trotskizm	trotskizm	trotskyzm
טראָצקיסט	trotskist	trotskist	trotskyst
טראַקטאָר	traktor	traktor	traktor
טרויב	troyb	troyb	troyb
טרוים	troym	troym	troym
טרומײט	trumeyt	trumeyt	trumyyt
טרומפּײט	trumpeyt	trumpeyt	trumpyyt
טרופּע	trupe	trupe	trupe
טרײסט	treyst	treyst	tryyst
טרילאָגיע	trilogye	trilogye	trylogye
טרעגער	treger	treger	treger
טרער	trer	trer	trer
טשאַטשקע	tshatshke	tshatshke	tshatshke
טשאָלנט	tsholnt	tsholnt	tsholnt
טשאַרדאַש	tshardash	tshardash	tshardash
טשיקאַװעס	tshikaves	tshikaves	tshykaves
טשעך	tshekh	tshekh	tshech
טשעכיש	tshekhish	tshekhish	tshechysh
טשעמאָדאַן	tshemodan	tshemodan	tshemodan
טשעקיסט	tshekist	tshekist	tshekyst
טשערנאָבל	tshernobl	tshernobl	tshernobl
טשערעפּאַכע	tsherepakhe	tsherepakhe	tsherepache
טשײַניק	tshaynik	tshaynik	tshaynyk
טײַװל	tayvl	tayvl	tayvl
טײַװעלע	tayvele	tayvele	tayvele
טײַטש	taytsh	taytsh	taytsh
טײַך	taykh	taykh	taych
טײַסטער	tayster	tayster	tayster
יאָג	yog	yog	yog
יאַגדע	yagde	yagde	yagde
יאָגורט	yogurt	yogurt	yogurt
יאַגעדע	yagede	yagede	yagede
יאָד	yod	yod	yod
יאָהר	yor	yohr	yohr
יאַנואַר	yanuar	yanuar	yanuar
יאָנץ	yonts	yonts	yonts
יאַפּאַניש	yapanish	yapanish	yapanysh
יאַפּאַנער	yapaner	yapaner	yapaner
יאָר	yor	yor	yor
יאָרהונדערט	yorhundert	yorhundert	yorhundert
יאָרטאָג	yortog	yortog	yortog
יאָרטויזנט	yortoyznt	yortoyznt	yortoyznt
יאַריד	yarid	yarid	yaryd
יאַרמולקע	yarmulke	yarmulke	yarmulke
יאַרמלקע	yarmlke	yarmlke	yarmlke
יאָרצענדלינג	yortsendling	yortsendling	yortsendlyng
יאָרצענדליק	yortsendlik	yortsendlik	yortsendlyk
יאָרצײַט	yortsayt	yortsayt	yortsayt
יאַשטשערקע	yashtsherke	yashtsherke	yashtsherke
יאר	yor	ir	yar
ידיעה	yedie	yedie	ydyeh
יוגנט	yugnt	yugnt	yugnt
יויך	yoykh	yoykh	yoych
יולי	yuli	yuli	yuly
יום	yom	yom	yum
יום־טובֿ	yontev	yontev	yum-tuv
יונג	yung	yung	yung
יונגער־מאַן	yunger-man	yunger-man	yunger-man
יוני	yuni	yuni	yuny
יוניאָן	yunyon	yunyon	yunyon
יופּיטער	yupiter	yupiter	yupyter
יחוס	yikhus	ikhus	ychus
ײִד	yid	eyִdalet	yyid
ײִדישיזם	yidishizm	eyִdishizm	yyidyshyzm
ײִדישיסט	yidishist	eyִdishist	yyidyshyst
ײִדישקײט	yidishkeyt	eyִdishkeyt	yyidyshkyyt
ײִדל	yidl	eyִdl	yyidl
ײִדענע	yidene	eyִdene	yyidene
ײִנגל	yingl	eyִngl	yyingl
ײִנגעלע	yingele	eyִngele	yyingele
ײִראת־הכּבֿוד	yires-hakoved	eyִrs-hkvud	yyiras-hkvud
ים	yam	yam	ym
ים־שטערן	yam-shtern	im-shtern	ym-shtern
יסורים	yisurem	yesurim	ysurym
יעגער	yeger	yeger	yeger
יעװסעקציע	yevsektsye	yevsektsye	yevsektsye
יענטע	yente	yente	yente
יעקע	yeke	yeke	yeke
יצר־הטובֿ	yeytser-hatoyv	itsr-htuv	ytsr-htuv
יצר־הרע	yeytser-hore	eyitser-hore	ytsr-hre
ירגזון	yirgozn	yirgozn	yrgzun
ירושה	yerushe	yerushe	yrushh
יריד	yarid	yarid	yryd
יש	yash	yash	ysh
ישיבֿה	yeshive	yeshive	yshyvh
ישיבֿה־בחור	yeshive-bokher	ishivh-bkhur	yshyvh-bchur
ישיבֿיש	yeshivish	ishivish	yshyvysh
ישיבה	yeshive	ishibh	yshybh
יתום	yosem	yosem	ysum
יתומה	yesoyme	yesoyme	ysumh
יתומל	yoseml	isuml	ysuml
כאַלװע	khalve	khalve	chalve
כאָסן	khosn	khosn	chosn
כאַסענע	khasene	khasene	chasene
כאַפּער	khaper	khaper	chaper
כּבֿוד	koved	koved	kvud
כּהונה	kehune	kehune	khunh
כװאַט	khvat	khvat	chvat
כװאַליע	khvalye	khvalye	chvalye
כּוח	koyekh	koyekh	kuch
כּזית	kezayes	kezais	kzys
כּח	koyekh	kkh	kch
כּלה	kale	kale	klh
כּלי־זײן	klezayen	kle-zain	kly-zyyn
כוליגאַן	khuligan	khuligan	chulygan
כּלל	klal	klal	kll
כּסלו	kislev	kslu	kslu
כּעס	kas	kaas	kes
כּשרות	kashres	kashres	kshrus
כּתובה	ksube	ksube	ksubh
כּתר	keser	keser	ksr
כינעזער	khinezer	khinezer	chynezer
כירורג	khirurg	khirurg	chyrurg
כירורגיע	khirurgye	khirurgye	chyrurgye
כמאַרע	khmare	khmare	chmare
כניאָק	khnyok	khnyok	chnyok
כעלמער	khelmer	khelmer	chelmer
כעלעמער	khelemer	khelemer	chelemer
כעמיע	khemye	khemye	chemye
כעמיקער	khemiker	khemiker	chemyker
כראַבינע	khrabine	khrabine	chrabyne
כראַביע	khrabye	khrabye	chrabye
כראָנאָלאָגיע	khronologye	khronologye	chronologye
כריזאַנטעמע	khrizanteme	khrizanteme	chryzanteme
כרײן	khreyn	khreyn	chryyn
כרעמזל	khremzl	khremzl	chremzl
כרעסטאָמאַטיע	khrestomatye	khrestomatye	chrestomatye
כשרות	kashres	khshrus	chshrus
כתר	keser	khsr	chsr
לאַבן	labn	labn	labn
לאָגאַריטם	logaritm	logaritm	logarytm
לאָגיק	logik	logik	logyk
לאַורעאַט	laureat	laureat	laureat
לאַטװיש	latvish	latvish	latvysh
לאַטוטניק	latutnik	latutnik	latutnyk
לאַטקע	latke	latke	latke
לאַם	lam	lam	lam
לאָמפּ	lomp	lomp	lomp
לאַנד	land	land	land
לאַנדסמאַן	landsman	landsman	landsman
לאַנדקאַרטע	landkarte	landkarte	landkarte
לאַפּסערדאַק	lapserdak	lapserdak	lapserdak
לאָפּעטע	lopete	lopete	lopete
לאַפֿער	lafer	lafer	lafer
לאַקס	laks	laks	laks
לאָקש	loksh	loksh	loksh
לאָרד	lord	lord	lord
לבֿנה	levone	levone	lvnh
להכעיס	lehakhes	lehakhes	lhcheys
לװיתן	levyosn	levyosn	lvysn
לוח	luekh	luekh	luch
לויב	loyb	loyb	loyb
לויז	loyz	loyz	loyz
לויער	loyer	loyer	loyer
לויתן	levyosn	loysn	loysn
לולבֿ	lulev	lulev	lulv
לונג	lung	lung	lung
לופֿט	luft	luft	luft
לופֿטמענטש	luftmentsh	luftmentsh	luftmentsh
לופֿטפֿעלד	luftfeld	luftfeld	luftfeld
ליאַלקע	lyalke	lyalke	lyalke
ליבע	libe	libe	lybe
ליבעלע	libele	libele	lybele
ליבשאַפֿט	libshaft	libshaft	lybshaft
ליגן	lign	lign	lygn
ליגנער	ligner	ligner	lygner
ליד	lid	lid	lyd
לידערבוך	liderbukh	liderbukh	lyderbuch
ליטװאַק	litvak	litvak	lytvak
ליטװינער	litviner	litviner	lytvyner
ליטװיש	litvish	litvish	lytvysh
ליטיום	litium	lityum	lytyum
ליטער	liter	liter	lyter
ליטעראַטור	literatur	literatur	lyteratur
לײב	leyb	leyb	lyyb
לײביכע	leybikhe	leybikhe	lyybyche
לײטער	leyter	leyter	lyyter
לײם	leym	leym	lyym
לײענונג	leyenung	leyenung	lyyenung
לײענער	leyener	leyener	lyyener
לײקע	leyke	leyke	lyyke
ליכט	likht	likht	lycht
ליכטל	likhtl	likhtl	lychtl
ליליע	lilye	lilye	lylye
לימאָנאַד	limonad	limonad	lymonad
לימוד	limed	limed	lymud
לימענע	limene	limene	lymene
לינגװיסט	lingvist	lingvist	lyngvyst
לינגװיסטיק	lingvistik	lingvistik	lyngvystyk
לינדז	lindz	lindz	lyndz
לינקיסט	linkist	linkist	lynkyst
ליפּ	lip	lip	lyp
ליק	lik	lik	lyk
למדן	lamdn	lamdn	lmdn
לעבל	lebl	lebl	lebl
לעבן	lebn	lebn	lebn
לעבער	leber	leber	leber
לעגענדע	legende	legende	legende
לעדער	leder	leder	leder
לעזער	lezer	lezer	lezer
לעטיש	letish	letish	letysh
לעמל	leml	leml	leml
לענד	lend	lend	lend
לענדן	lendn	lendn	lendn
לעניניזם	leninizm	leninizm	lenynyzm
לעניניסט	leninist	leninist	lenynyst
לעפּל	lepl	lepl	lepl
לעפֿל	lefl	lefl	lefl
לעק	lek	lek	lek
לעקער	leker	leker	leker
לעקערל	lekerl	lekerl	lekerl
לעקציע	lektsye	lektsye	lektsye
לערנונג	lernung	lernung	lernung
לערנײִנגל	lernyingl	lerneyִngl	lernyyingl
לערער	lerer	lerer	lerer
לערערין	lererin	lererin	lereryn
לץ	lets	lets	lts
לצעכע	leytsekhe	ltsekhe	ltseche
לשון	loshn	loshn	lshun
לשון־קודש	loshn-koydesh	loshn-koydesh	lshun-kudsh
לײַב	layb	layb	layb
לײַבל	laybl	laybl	laybl
לײַבקע	laybke	laybke	laybke
לײַװנט	layvnt	layvnt	layvnt
לײַט	layt	layt	layt
מאָביל־טעלעפֿאָן	mobil-telefon	mobil-telefon	mobyl-telefon
מאָבילקע	mobilke	mobilke	mobylke
מאָגן	mogn	mogn	mogn
מאַגנעט	magnet	magnet	magnet
מאַדזשאַר	madzhar	madzhar	madzhar
מאָדערניזם	modernizm	modernizm	modernyzm
מאָדערניסט	modernist	modernist	modernyst
מאַהאַראַדזשאַ	maharadzha	maharadzha	maharadzha
מאָטאָציקל	mototsikl	mototsikl	mototsykl
מאַטעמאַטיק	matematik	matematik	matematyk
מאַטעריע	materye	materye	materye
מאַי	may	mai	may
מאַך	makh	makh	mach
מאָך	mokh	mokh	moch
מאַכאָרקע	makhorke	makhorke	machorke
מאַכט	makht	makht	macht
מאַכער	makher	makher	macher
מאָל	mol	mol	mol
מאָלעקול	molekul	molekul	molekul
מאָלער	moler	moler	moler
מאָלערײַ	moleray	moleray	moleray
מאַלפּע	malpe	malpe	malpe
מאָלצײַט	moltsayt	moltsayt	moltsayt
מאַמינקע	maminke	maminke	mamynke
מאַמע	mame	mame	mame
מאַמע־לשון	mame-loshn	mameloshn	mame-lshun
מאָמענט	moment	moment	moment
מאַמעניו	mamenyu	mamenyu	mamenyu
מאַמעשי	mameshi	mameshi	mameshy
מאַן	man	man	man
מאָנאַט	monat	monat	monat
מאָנאָלאָג	monolog	monolog	monolog
מאָנאָפּאָל	monopol	monopol	monopol
מאַנגאָ	mango	mango	mango
מאַנגאַן	mangan	mangan	mangan
מאַנגאַנעז	manganez	manganez	manganez
מאַנדאָלינע	mandoline	mandoline	mandolyne
מאַנדל	mandl	mandl	mandl
מאַנדלאַך	mandlakh	mandlakh	mandlach
מאַנדלבוים	mandlboym	mandlboym	mandlboym
מאַנדלבראָט	mandlbrot	mandlbrot	mandlbrot
מאַנדלעך	mandlekh	mandlekh	mandlech
מאָנטיק	montik	montik	montyk
מאָניזם	monizm	monizm	monyzm
מאָניסט	monist	monist	monyst
מאַנסביל	mansbil	mansbil	mansbyl
מאַנספּאַרשוין	mansparshoyn	mansparshoyn	mansparshoyn
מאָס	mos	mos	mos
מאַסלינע	masline	masline	maslyne
מאָסקװער	moskver	moskver	moskver
מאָראַל	moral	moral	moral
מאַראַנץ	marants	marants	marants
מאָרגן	morgn	morgn	morgn
מאָרגנשטערן	morgnshtern	morgnshtern	morgnshtern
מאָרדע	morde	morde	morde
מאַרך	markh	markh	march
מאַרמאַלאַד	marmalad	marmalad	marmalad
מאַרמאָלאַד	marmolad	marmolad	marmolad
מאַרמאָר	marmor	marmor	marmor
מאַרמעלאַד	marmelad	marmelad	marmelad
מאַרמער	marmer	marmer	marmer
מאַרץ	marts	marts	marts
מאַרק	mark	mark	mark
מאַרקסיזם	marksizm	marksizm	marksyzm
מאַרקסיסט	marksist	marksist	marksyst
מאַרש	marsh	marsh	marsh
מאַשין	mashin	mashin	mashyn
מאדים	madim	maydem	madym
מאכל	maykhl	maykhl	machl
מאמר	maymer	maymer	mamr
מבֿין	meyvn	meyvn	mvyn
מגילה	megile	megile	mgylh
מדבר	midber	midber	mdbr
מדינה	medine	medine	mdynh
מדרגה	madreyge	madreyge	mdrgh
מדרש	medrash	medresh	mdrsh
מוהל	moyel	moyel	muhl
מװת	moves	mvs	mvs
מוזײ	muzey	muzey	muzyy
מוזיק	muzik	muzik	muzyk
מוזיקער	muziker	muziker	muzyker
מוח	moyekh	moyekh	much
מוט	mut	mut	mut
מוטער	muter	muter	muter
מוטער־צײכן	muter-tseykhn	muter-tseykhn	muter-tsyychn
מוטער־שפּראַך	muter-shprakh	muter-shprakh	muter-shprach
מוטערטראַכט	mutertrakht	mutertrakht	mutertracht
מוטערלאַנד	muterland	muterland	muterland
מוטערשײד	mutersheyd	mutersheyd	mutershyyd
מוטערשפּראַך	mutershprakh	mutershprakh	mutershprach
מויד	moyd	moyd	moyd
מויז	moyz	moyz	moyz
מויל	moyl	moyl	moyl
מוכר־ספֿרים	moykher-sforim	moykher-sforim	muchr-sfrym
מוסולמאַן	musulman	musulman	musulman
מוסקל	muskl	muskl	muskl
מורא	moyre	moyre	mura
מוראַשקע	murashke	murashke	murashke
מזוזה	mezuze	mezuze	mzuzh
מזל	mazl	mazl	mzl
מזרח	mizrekh	mzrkh	mzrch
מחבר	mekhaber	mekhaber	mchbr
מחותּן	mekhutn	mekhutn	mchutn
מחותּנישאַפֿט	mekhutonishaft	mekhutoneshaft	mchutnyshaft
מחותּנתטע	mekhuteneste	makheteneste	mchutnste
מחיה	mekháye	mekhaye	mchyh
מחלוקת	makhloykes	makhloykes	mchluks
מטבע	matbeye	matbeye	mtbe
מיאַטע	myate	myate	myate
מיאוסקײט	meyeskeyt	mieskeyt	myuskyyt
מידקײט	midkeyt	midkeyt	mydkyyt
מיט	mit	mit	myt
מיטה	mite	mite	myth
מיטװאָך	mitvokh	mitvokh	mytvoch
מיטל	mitl	mitl	mytl
מיטלהויכדײַטש	mitlhoykhdaytsh	mitlhoykhdaytsh	mytlhoychdaytsh
מיטלשול	mitlshul	mitlshul	mytlshul
מיטן	mitn	mitn	mytn
מײדל	meydl	meydl	myydl
מײדעלע	meydele	meydele	myydele
מײנונג	meynung	meynung	myynung
מילגרוים	milgroym	milgroym	mylgroym
מילה	mile	mile	mylh
מיליאָן	milyon	milyon	mylyon
מיליאָנער	milyoner	milyoner	mylyoner
מיליאַרד	milyard	milyard	mylyard
מיליגראַם	miligram	miligram	mylygram
מיליטאַנט	militant	militant	mylytant
מיליטער	militer	militer	mylyter
מיליליטער	mililiter	mililiter	mylylyter
מילימעטער	milimeter	milimeter	mylymeter
מילך	milkh	milkh	mylch
מילכיגער	milkhiger	milkhiger	mylchyger
מילכיקער	milkiker	milkhiker	mylchyker
מילעך	milekh	milekh	mylech
מין	min	min	myn
מינאַרעט	minaret	minaret	mynaret
מינדערהײט	minderheyt	minderheyt	mynderhyyt
מינוט	minut	minut	mynut
מיניסטער	minister	minister	mynyster
מינסקער	minsker	minsker	mynsker
מינעראַל־װאַסער	mineral-vaser	mineral-vaser	myneral-vaser
מינץ	mints	mints	mynts
מיסטיציזם	mistitsizm	mistitsizm	mystytsyzm
מיענטע	myente	myente	myente
מיקראָפֿילם	mikrofilm	mikrofilm	mykrofylm
מירמל	mirml	mirml	myrml
מישנה	mishne	mishne	myshnh
מישפּאָכע	mishpokhe	mishpokhe	myshpoche
מכּבי	makabi	makabi	mkby
מכּבײער	makabeyer	makabeyer	mkbyyer
מכּה	make	make	mkh
מלאָכה	melokhe	melokhe	mlochh
מלאך	malekh	malekh	mlach
מלאך־המות	malakhamoves	mlkh-hmus	mlach-hmus
מלאכה	melokhe	mlkhh	mlachh
מלוכה	melukhe	melukhe	mluchh
מלחמה	milkhome	milkhome	mlchmh
מלך	meylekh	meylekh	mlch
מלכה	malke	mlkhh	mlchh
מלכּה	malke	malke	mlkh
מלמד	melamed	melamed	mlmd
ממשלה	memshole	memshole	mmshlh
מן	man	man	mn
מנגן	menagan	menagn	mngn
מנהג	mineg	mnhg	mnhg
מנורה	mnoyre	menoyre	mnurh
מנחה	minkhe	mnkhh	mnchh
מנין	minyen	minyen	mnyn
מסורה	mesoyre	mesoyre	msurh
מסירה	mesire	mesire	msyrh
מסכתא	mesekhte	mskhs	mschsa
מסכתּא	mesekhte	mesekhte	mschta
מספּר	misper	mspr	mspr
מעבל	mebl	mebl	mebl
מעדיקאַמענט	medikament	medikament	medykament
מעטאָד	metod	metod	metod
מעטאָדיסט	metodist	metodist	metodyst
מעטאָדיק	metodik	metodik	metodyk
מעטאָדע	metode	metode	metode
מעטאַפֿיזיק	metafizik	metafizik	metafyzyk
מעטעאָראָלאָגיע	meteorologye	meteorologye	meteorologye
מעטער	meter	meter	meter
מעטראָ	metro	metro	metro
מעטשעט	metshet	metshet	metshet
מעכאַניקער	mekhaniker	mekhaniker	mechanyker
מעל	mel	mel	mel
מעלאָן	melon	melon	melon
מעלה	mayle	mayle	melh
מעמואַרן	memuarn	memuarn	memuarn
מענטש	mentsh	mentsh	mentsh
מעסער	meser	meser	meser
מעקלער	mekler	mekler	mekler
מער	mer	mer	mer
מערב	mayrev	merb	merb
מערבֿ	mayrev	mayrev	merv
מערהײט	merheyt	merheyt	merhyyt
מערכה	marokhe	marokhe	merchh
מערצאָל	mertsol	mertsol	mertsol
מעש	mesh	mesh	mesh
מעשׂה	mayse/manse	mayse	mesh
מעשה	mayse/manse	meshh	meshh
מפֿטיר	mafter	mafter	mftyr
מצה	matse	matse	mtsh
מציאה	metsiye	metsie	mtsyah
מקװה	mikve	mkvh	mkvh
מקום	mokem	mokem	mkum
משׂכּיל	maskil	maskl	mskyl
משוגענער	meshugener	meshugener	mshugener
משוגעת	meshugas	meshugas	mshuges
משיח	moshiyekh	meshiekh	mshych
משל	moshl	moshl	mshl
משפּחה	mishpokhe	mishpokhe	mshpchh
משפחה	mishpokhe	mshפkhh	mshfchh
משקה	mashke	mashke	mshkh
מת	meys	mes	ms
מתּנה	matone	matone	mtnh
מתנגד	misnaged	misnaged	msngd
מײַ	may	may	may
מײַל	mayl	mayl	mayl
מײַסטער	mayster	mayster	mayster
נאַגאַן	nagan	nagan	nagan
נאָגל	nogl	nogl	nogl
נאָדל	nodl	nodl	nodl
נאָװעמבער	november	november	november
נאָז	noz	noz	noz
נאָזלאָך	nozlokh	nozlokh	nozloch
נאַטור	natur	natur	natur
נאַכט	nakht	nakht	nacht
נאַכטהעמד	nakhthemd	nakhthemd	nachthemd
נאָכלויפֿער	nokhloyfer	nokhloyfer	nochloyfer
נאָמען	nomen	nomen	nomen
נאָס	nos	nos	nos
נאַצי	natsi	natsi	natsy
נאַציאָנאַל־סאָציאַליזם	natsyonal-sotsyalizm	natsyonal-sotsyalizm	natsyonal-sotsyalyzm
נאַציאָנאַליזם	natsyonalizm	natsyonalizm	natsyonalyzm
נאַציזם	natsizm	natsizm	natsyzm
נאַקן	nakn	nakn	nakn
נאַר	nar	nar	nar
נאַרישקײט	narishkeyt	narishkeyt	naryshkyyt
נבֿואה	nevue	nevue	nvuah
נבֿיא	novi	novi	nvya
נבֿיאה	neviye	nevie	nvyah
נגיד	ngid	noged	ngyd
נדן	nadn	nadn	ndn
נואף	noyef	noyef	nuaf
נודניק	nudnik	nudnik	nudnyk
נול	nul	nul	nul
נומער	numer	numer	numer
נוס	nus	nus	nus
נוסח	nusekh	nusekh	nusch
נוץ	nuts	nuts	nuts
נוקלעאָן	nukleon	nukleon	nukleon
נחת	nakhes	nakhes	nchs
ניאוף	nief	nief	nyuf
ניגון	nign	nign	nygun
ניגונדל	nigndl	nigndl	nygundl
ניהיליזם	nihilizm	nihilizm	nyhylyzm
ניהיליסט	nihilist	nihilist	nyhylyst
ניװאָ	nivo	nivo	nyvo
ניטל	nitl	nitl	nytl
ניטלבוים	nitlboym	nitlboym	nytlboym
נײטראָן	neytron	neytron	nyytron
נײמאַשין	neymashin	neymashin	nyymashyn
ניס	nis	nis	nys
ניסל	nisl	nisl	nysl
ניסן	nisn	nisn	nysn
ניסערײַ	niseray	niseray	nyseray
ניקוד	niked	niked	nykud
ניקל	nikl	nikl	nykl
ניר	nir	nir	nyr
נס	nes	nes	ns
נעאָן	neon	neon	neon
נעביש	nebish	nebish	nebysh
נעגער	neger	neger	neger
נעגערטע	negerte	negerte	negerte
נעװראָלאָגיע	nevrologye	nevrologye	nevrologye
נעסט	nest	nest	nest
נעפּטון	neptun	neptun	neptun
נעפּטוניום	neptunyum	neptunyum	neptunyum
נעפּל	nepl	nepl	nepl
נעץ	nets	nets	nets
נערװ	nerv	nerv	nerv
נקמה	nekome	nekome	nkmh
נשמה	neshome	neshome	nshmh
נײַנטל	nayntl	nayntl	nayntl
נײַנציקסטל	nayntsikstl	nayntsikstl	nayntsykstl
נײַנצנטל	nayntsntl	nayntsntl	nayntsntl
נײַעס	nayes	nayes	nayes
סאָד	sod	sod	sod
סאָדע	sode	sode	sode
סאָװיעט	sovyet	sovyet	sovyet
סאָװע	sove	sove	sove
סאָװעטיזאַציע	sovetizatsye	sovetizatsye	sovetyzatsye
סאַזשלקע	sazhlke	sazhlke	sazhlke
סאַטורן	saturn	saturn	saturn
סאַלאַט	salat	salat	salat
סאָלדאַט	soldat	soldat	soldat
סאַמאָדערזשאַװיע	samoderzhavye	samoderzhavye	samoderzhavye
סאָסנע	sosne	sosne	sosne
סאָפֿע	sofe	sofe	sofe
סאָציאָלאָג	sotsyolog	sotsyolog	sotsyolog
סאָציאָלאָגיע	sotsyologye	sotsyologye	sotsyologye
סאָציאַליזם	sotsyalizm	sotsyalizm	sotsyalyzm
סאָציאַליסט	sotsyalist	sotsyalist	sotsyalyst
סאַקסאָפֿאָן	saksofon	saksofon	saksofon
סאַראָקע	saroke	saroke	saroke
סאָראָקע	soroke	soroke	soroke
סבֿיבֿה	svive	svive	svyvh
סדר	seyder	seyder	sdr
סובאָטניק	subotnik	subotnik	subotnyk
סובסטאַנטיװ	substantiv	substantiv	substantyv
סוד	sod	sod	sud
סולטאַן	sultan	sultan	sultan
סוף	sof	sof	suf
סופֿר	soyfer	soyfer	sufr
סחורה	skhoyre	skhoyre	schurh
סטאַװ	stav	stav	stav
סטאַטיסטיק	statistik	statistik	statystyk
סטאָליאַר	stolyar	stolyar	stolyar
סטאַליניזם	stalinizm	stalinizm	stalynyzm
סטאַליניסט	stalinist	stalinist	stalynyst
סטאָליער	stolyer	stolyer	stolyer
סטאַשקע	stashke	stashke	stashke
סטאַשקעשמיר	stashkeshmir	stashkeshmir	stashkeshmyr
סטודיאָ	studyo	studyo	studyo
סטודיע	studye	studye	studye
סטודענט	student	student	student
סטודענטין	studentin	studentin	studentyn
סטודענטקע	studentke	studentke	studentke
סטרוזש	struzh	struzh	struzh
סטרונע	strune	strune	strune
סיבירער	sibirer	sibirer	sybyrer
סידור	sider	sider	sydur
סיװן	sivn	sivn	syvn
סײם	seym	seym	syym
סײמיסט	seymist	seymist	syymyst
סיליציום	silitsyum	silitsyum	sylytsyum
סיליקאָן	silikon	silikon	sylykon
סימבאָל	simbol	simbol	symbol
סימן	simen	simen	symn
סינאַגאָגע	sinagoge	sinagoge	synagoge
סיראָפּ	sirop	sirop	syrop
סירופּ	sirup	sirup	syrup
סלאָװאַק	slovak	slovak	slovak
סלאָװאַקיש	slovakish	slovakish	slovakysh
סם	sam	sam	sm
סמאָקינג	smoking	smoking	smokyng
סמאַראַגד	smaragd	smaragd	smaragd
סמיכה	smikhe	smikhe	smychh
סמעטענע	smetene	smetene	smetene
סנאָפּ	snop	snop	snop
סעודה	sude	sude	seudh
סעלעריע	selerye	selerye	selerye
סענאַט	senat	senat	senat
סענאַטאָר	senator	senator	senator
סעניאָר	senyor	senyor	senyor
סעניאָראַ	senyora	senyora	senyora
סעפּטעמבער	september	september	september
סעקונדע	sekunde	sekunde	sekunde
סעקטע	sekte	sekte	sekte
סעקס	seks	seks	seks
סערביש	serbish	serbish	serbysh
סערװעטקע	servetke	servetke	servetke
סעריע	serye	serye	serye
ספּאָדיק	spodik	spodik	spodyk
ספּאָדניצע	spodnitse	spodnitse	spodnytse
ספּאָדעק	spodek	spodek	spodek
ספּאַרזשע	sparzhe	sparzhe	sparzhe
ספּודניצע	spudnitse	spudnitse	spudnytse
ספּיריטואַליזם	spiritualizm	spiritualizm	spyrytualyzm
ספּעקטאַקל	spektakl	spektakl	spektakl
ספֿר	seyfer	seyfer	sfr
ספֿר־תּורה	seyfer-toyre	seyfer-toyre	sfr-turh
סקאָרפּיאָן	skorpyon	skorpyon	skorpyon
סתּירה	stire	stire	styrh
עבֿרה	aveyre	evrh	evrh
עבֿרי	ivre	ivre	evry
עד	eyd	ad	ed
עולם	oylem	oylem	eulm
עומר	oymer	oymer	eumr
עוף	of	of	euf
עופֿעלע	eyfele	eyfele	eufele
עטיק	etik	etik	etyk
עטנאָגראַפֿיע	etnografye	etnografye	etnografye
עיבור־יאָר	iber-yor	iber-yor	eybur-yor
עילוי	ile	ile	eyloy
עין־הרע	eyn-hore	eynhore	eyn-hre
עלטערן	eltern	eltern	eltern
עלטערנס	elterns	elterns	elterns
עליה	alie	alie	elyh
עלנבויגן	elnboygn	elnboygn	elnboygn
עלעגיע	elegye	elegye	elegye
עלעפֿאַנט	elefant	elefant	elefant
עלעקטראָן	elektron	elektron	elektron
עלעקטריע	elektrye	elektrye	elektrye
עלעקטריציטעט	elektritsitet	elektritsitet	elektrytsytet
עלעקטריקער	elektriker	elektriker	elektryker
עלעקטרע	elektre	elektre	elektre
עלף	elf	elf	elf
עלפֿטל	elftl	elftl	elftl
עם הארץ	amorets	im hrts	em harts
עם־האָרץ	amorets	amorets	em-horts
עמיגראַנט	emigrant	emigrant	emygrant
עמיגראַציע	emigratsye	emigratsye	emygratsye
עמך	amkho	amkho	emch
עמער	emer	emer	emer
ענגליש	english	english	englysh
ענטפֿער	entfer	entfer	entfer
ענין	inyen	inyen	enyn
ענלעכקײט	enlekhkeyt	enlekhkeyt	enlechkyyt
ענערגיע	energye	energye	energye
ענציקלאָפּעדיע	entsiklopedye	entsiklopedye	entsyklopedye
ענקאַװעדעניק	enkavedenik	enkavedenik	enkavedenyk
עסטרײַכער	estraykher	estraykher	estraycher
עסײ	esey	esey	esyy
עסיק	esik	esik	esyk
עסן	esn	esn	esn
עספּעראַנטאָ	esperanto	esperanto	esperanto
עפּאָכע	epokhe	epokhe	epoche
עפּידעמיאָלאָגיע	epidemyologye	epidemyologye	epydemyologye
עפּידעמיע	epidemye	epidemye	epydemye
עפּילאָג	epilog	epilog	epylog
עפּיסטעמאָלאָגיע	epistemologye	epistemologye	epystemologye
עפּל	epl	epl	epl
עפּלבוים	eplboym	eplboym	eplboym
עפּלזאַפֿט	eplzaft	eplzaft	eplzaft
עצה	eytse	eytse	etsh
עקאָנאָמיע	ekonomye	ekonomye	ekonomye
עקאָנאָמיק	ekonomik	ekonomik	ekonomyk
עקדיש	ekdish	ekdish	ekdysh
עקװאַטאָר	ekvator	ekvator	ekvator
עקזעמפּלאַר	ekzemplar	ekzemplar	ekzemplar
עקזעקוציע	ekzekutsye	ekzekutsye	ekzekutsye
עקרה	akore	akore	ekrh
עראָפּאָרט	eroport	eroport	eroport
עראָפּלאַן	eroplan	eroplan	eroplan
ערד	erd	erd	erd
ערדאַרבעטער	erdarbeter	erdarbeter	erdarbeter
פֿאַבריק	fabrik	fabrik	fabryk
פֿאָדעם	fodem	fodem	fodem
פֿאַזאַן	fazan	fazan	fazan
פֿאָטער	foter	foter	foter
פֿאָטערלאַנד	foterland	foterland	foterland
פֿאָך	fokh	fokh	foch
פֿאָלק	folk	folk	folk
פֿאָלקלאָר	folklor	folklor	folklor
פֿאָלקסביבליאָטעק	folksbiblyotek	folksbiblyotek	folksbyblyotek
פֿאָלקסװערטל	folksvertl	folksvertl	folksvertl
פֿאָלקסרעפּובליק	folksrepublik	folksrepublik	folksrepublyk
פֿאָלקסשול	folksshul	folksshul	folksshul
פֿאַמיליע	familye	familye	famylye
פֿאָן	fon	fon	fon
פֿאָנאָלאָגיע	fonologye	fonologye	fonologye
פֿאָנעטיק	fonetik	fonetik	fonetyk
פֿאָנעם	fonem	fonem	fonem
פֿאַסאָליע	fasolye	fasolye	fasolye
פֿאָסיל	fosil	fosil	fosyl
פֿאָספֿאַט	fosfat	fosfat	fosfat
פֿאַקט	fakt	fakt	fakt
פֿאַקטאָר	faktor	faktor	faktor
פֿאַראַכטונג	farakhtung	farakhtung	farachtung
פֿאַראײן	fareyn	fareyn	farayyn
פֿאַראײניקונג	fareynikung	fareynikung	farayynykung
פֿאַרב	farb	farb	farb
פֿאַרבאַנד	farband	farband	farband
פֿאַרבעסערונג	farbeserung	farbeserung	farbeserung
פֿאַרברעך	farbrekh	farbrekh	farbrech
פֿאַרברעכער	farbrekher	farbrekher	farbrecher
פֿאַרברענגען	farbrengen	farbrengen	farbrengen
פֿאַרגאַנג	fargang	fargang	fargang
פֿאַרגאַנגענהײט	fargangenheyt	fargangenheyt	fargangenhyyt
פֿאַרגעװאַלדיגונג	fargevaldigung	fargevaldigung	fargevaldygung
פֿאַרגעניגן	fargenign	fargenign	fargenygn
פֿאַרטאָג	fartog	fartog	fartog
פֿאַרלאַג	farlag	farlag	farlag
פֿאַרמער	farmer	farmer	farmer
פֿאָרעם	forem	forem	forem
פֿאַרפֿל	farfl	farfl	farfl
פֿאָרץ	forts	forts	forts
פֿאַרקויף	farkoyf	farkoyf	farkoyf
פֿאַרקויפֿער	farkoyfer	farkoyfer	farkoyfer
פֿאַרקויפֿערין	farkoyferin	farkoyferin	farkoyferyn
פֿאָרשונג	forshung	forshung	forshung
פֿאָרשטעלונג	forshtelung	forshtelung	forshtelung
פֿאַשיזם	fashizm	fashizm	fashyzm
פֿאַשיסט	fashist	fashist	fashyst
פאכװע	pakhve	פkhve	fachve
פאר	far	פr	far
פּאָגראָם	pogrom	pogrom	pogrom
פּאָדלאָגע	podloge	podloge	podloge
פּאָדקאָװע	podkove	podkove	podkove
פּאָדקעװע	podkeve	podkeve	podkeve
פּאַה	peye	pah	pah
פּאָװידלע	povidle	povidle	povydle
פּאַװע	pave	pave	pave
פּאָטאַסיום	potasyum	potasyum	potasyum
פּאַטלעזשאַן	patlezhan	patlezhan	patlezhan
פּאָטקאָװע	potkove	potkove	potkove
פּאָטקעװע	potkeve	potkeve	potkeve
פּאַטריאָט	patryot	patryot	patryot
פּאַטריאָטיזם	patryotizm	patryotizm	patryotyzm
פּאַיאַץ	payats	payats	payats
פּאָיעזד	poyezd	poyezd	poyezd
פּאַכװע	pakhve	pakhve	pachve
פּאַלאַץ	palats	palats	palats
פּאָליאַטשקע	polyatshke	polyatshke	polyatshke
פּאָליאַנער	polyaner	polyaner	polyaner
פּאָליאַק	polyak	polyak	polyak
פּאָליטיק	politik	politik	polytyk
פּאָליציאַנט	politsyant	politsyant	polytsyant
פּאָליצײ	politsey	politsey	polytsyy
פּאָליציסט	politsist	politsist	polytsyst
פּאָליצע	politse	politse	polytse
פּאַלעאָנטאָלאָג	paleontolog	paleontolog	paleontolog
פּאַלעאָנטאָלאָגיע	paleontologye	paleontologye	paleontologye
פּאַלעסטינער	palestiner	palestiner	palestyner
פּאָמידאָר	pomidor	pomidor	pomydor
פּאָמעראַנץ	pomerants	pomerants	pomerants
פּאָמפּערניקל	pompernikl	pompernikl	pompernykl
פּאַן	pan	pan	pan
פּאַני	pani	pani	pany
פּאָסט	post	post	post
פּאַסטושקע	pastushke	pastushke	pastushke
פּאַסטעך	pastekh	pastekh	pastech
פּאַסטראַמי	pastrami	pastrami	pastramy
פּאַסטראַמע	pastrame	pastrame	pastrame
פּאַסכע	paskhe	paskhe	pasche
פּאַסקודניאַק	paskudnyak	paskudnyak	paskudnyak
פּאָעזיע	poezye	poezye	poezye
פּאָעט	poet	poet	poet
פּאָעם	poem	poem	poem
פּאָעמע	poeme	poeme	poeme
פּאָפּוגײַ	popugay	popugay	popugay
פּאַפּיראָס	papiros	papiros	papyros
פּאַפּירעסל	papiresl	papiresl	papyresl
פּאַפּריקע	paprike	paprike	papryke
פּאָץ	pots	pots	pots
פּאָקן	pokn	pokn	pokn
פּאָר	por	por	por
פּאַראַדאָקס	paradoks	paradoks	paradoks
פּאַראָדיסט	parodist	parodist	parodyst
פּאַראָדיע	parodye	parodye	parodye
פּאַראַפּסיכאָלאָגיע	parapsikhologye	parapsikhologye	parapsychologye
פּאַרטיזאַן	partizan	partizan	partyzan
פּאַרטײ	partey	partey	partyy
פּאַריזער	parizer	parizer	paryzer
פּאָרל	porl	porl	porl
פּאָרנאָגראַפֿיע	pornografye	pornografye	pornografye
פּאַרע	pare	pare	pare
פּאָרפֿאָלק	porfolk	porfolk	porfolk
פּאַרק	park	park	park
פּאַרשוין	parshoyn	parshoyn	parshoyn
פּאַשאַ	pasha	pasha	pasha
פּאה	peye	peye	pah
פּוד	pud	pud	pud
פּוטער	puter	puter	puter
פּויליש	poylish	poylish	poylysh
פּויער	poyer	poyer	poyer
פּויפּס	poyps	poyps	poyps
פּויפּסט	poypst	poypst	poypst
פּויק	poyk	poyk	poyk
פּויקשטעקל	poykshtekl	poykshtekl	poykshtekl
פּונקט	punkt	punkt	punkt
פּורימשפּיל	purimshpil	purimshpil	purymshpyl
פּושקע	pushke	pushke	pushke
פֿוטער	futer	futer	futer
פּיאַװקע	pyavke	pyavke	pyavke
פּיאַטע	pyate	pyate	pyate
פּיאָן	pyon	pyon	pyon
פּיאַנע	pyane	pyane	pyane
פֿויגל	foygl	foygl	foygl
פּידקאָװע	pidkove	pidkove	pydkove
פּיזשאַמעס	pizhames	pizhames	pyzhames
פּילאָט	pilot	pilot	pylot
פּינגװין	pingvin	pingvin	pyngvyn
פֿויסט	foyst	foyst	foyst
פּיסטויל	pistoyl	pistoyl	pystoyl
פּיסק	pisk	pisk	pysk
פּיעסע	pyese	pyese	pyese
פּיפּערנאָטער	pipernoter	pipernoter	pypernoter
פּיצע	pitse	pitse	pytse
פּיקהאָלץ	pikholts	pikholts	pykholts
פּיראָג	pirog	pirog	pyrog
פּירוש	peyresh	peyresh	pyrush
פּירושקע	pirushke	pirushke	pyrushke
פּלאַזשע	plazhe	plazhe	plazhe
פּלאַטינום	platinum	platinum	platynum
פּלאַנעט	planet	planet	planet
פּלאַנעטע	planete	planete	planete
פּלאַץ	plats	plats	plats
פּלוטאָ	pluto	pluto	pluto
פּלוטאָניום	plutonyum	plutonyum	plutonyum
פּליוש	plyush	plyush	plyush
פּליט	polet	polet	plyt
פּליטה	pleyte	pleyte	plyth
פּלײצע	pleytse	pleytse	plyytse
פּלימעניצע	plimenitse	plimenitse	plymenytse
פּלימעניק	plimenik	plimenik	plymenyk
פּלעצל	pletsl	pletsl	pletsl
פּלשתּי	plishti	plshti	plshty
פֿונגוס	fungus	fungus	fungus
פֿונט	funt	funt	funt
פּנים	ponem	ponem	pnym
פּנימל	peneml	peneml	pnyml
פֿונק	funk	funk	funk
פֿוס	fus	fus	fus
פֿוסבאַל	fusbal	fusbal	fusbal
פֿוסבאָל	fusbol	fusbol	fusbol
פֿוסבאַליסט	fusbalist	fusbalist	fusbalyst
פֿוסבאָליסט	fusbolist	fusbolist	fusbolyst
פּסוק	posek	posek	psuk
פּסיכאָאַנאַליז	psikhoanaliz	psikhoanaliz	psychoanalyz
פּסיכאָאַנאַליטיקער	psikhoanalitiker	psikhoanalitiker	psychoanalytyker
פּסיכאָלאָג	psikholog	psikholog	psycholog
פּסיכאָלאָגיע	psikhologye	psikhologye	psychologye
פּסיכע	psikhe	psikhe	psyche
פּעדלער	pedler	pedler	pedler
פּעליקאַן	pelikan	pelikan	pelykan
פּעלץ	pelts	pelts	pelts
פּעמפּיק	pempik	pempik	pempyk
פּעניס	penis	penis	penys
פּעסאָ	peso	peso	peso
פּעקלפֿלײש	peklfleysh	peklfleysh	peklflyysh
פּערל	perl	perl	perl
פֿופֿציקסטל	fuftsikstl	fuftsikstl	fuftsykstl
פֿופֿצנטל	fuftsntl	fuftsntl	fuftsntl
פֿוקס	fuks	fuks	fuks
פּראָבלעם	problem	problem	problem
פּראָבע	probe	probe	probe
פּראָזע	proze	proze	proze
פּראָטאָן	proton	proton	proton
פּראָיעקט	proyekt	proyekt	proyekt
פּראָלאָג	prolog	prolog	prolog
פּראָנאָם	pronom	pronom	pronom
פּראָפֿעסאָר	profesor	profesor	profesor
פּראָפֿעסיע	profesye	profesye	profesye
פּראָפֿ׳	prof'	prof׳	prof׳
פּראָצענט	protsent	protsent	protsent
פּראַקטיק	praktik	praktik	praktyk
פּרוסאַק	prusak	prusak	prusak
פּרט	prat	prat	prt
פּריז	priz	priz	pryz
פּריזיװ	priziv	priziv	pryzyv
פּריזיװניק	prizivnik	prizivnik	pryzyvnyk
פּרינץ	prints	prints	prynts
פּרינציפּ	printsip	printsip	pryntsyp
פּרינצעסין	printsesin	printsesin	pryntsesyn
פּריפּעטשיק	pripetshik	pripetshik	prypetshyk
פּרעזידענט	prezident	prezident	prezydent
פּרעמיע	premye	premye	premye
פּרעמיער	premyer	premyer	premyer
פּרעפּאָזיציע	prepozitsye	prepozitsye	prepozytsye
פּרשה	parshe	parshe	prshh
פּרײַז	prayz	prayz	prayz
פּתח	pasekh	pasekh	psch
פּײַן	payn	payn	payn
פּײַקל	paykl	paykl	paykl
פּײַקלער	paykler	paykler	paykler
פֿי	fi	fi	fy
פֿיאַלקע	fyalke	fyalke	fyalke
פֿידל	fidl	fidl	fydl
פֿידלער	fidler	fidler	fydler
פֿיזיק	fizik	fizik	fyzyk
פֿיזיקער	fiziker	fiziker	fyzyker
פֿײגעלע	feygele	feygele	fyygele
פֿיך	fikh	fikh	fych
פֿילאָלאָג	filolog	filolog	fylolog
פֿילאָלאָגיע	filologye	filologye	fylologye
פֿילאָסאָפֿיע	filosofye	filosofye	fylosofye
פֿילם	film	film	fylm
פֿינאַנץ	finants	finants	fynants
פינגער	finger	פinger	fynger
פֿינגער	finger	finger	fynger
פֿינגערל	fingerl	fingerl	fyngerl
פֿיניש	finish	finish	fynysh
פֿינסטערניש	finsternish	finsternish	fynsternysh
פֿינפֿטל	finftl	finftl	fynftl
פֿינצטערניש	fintsternish	fintsternish	fyntsternysh
פֿיסטאַשקע	fistashke	fistashke	fystashke
פֿיסל	fisl	fisl	fysl
פֿירזאָגערין	firzogerin	firzogerin	fyrzogeryn
פֿירמע	firme	firme	fyrme
פֿירער	firer	firer	fyrer
פֿיש	fish	fish	fysh
פֿישער	fisher	fisher	fysher
פֿלאַטערל	flaterl	flaterl	flaterl
פֿלאַם	flam	flam	flam
פֿלאַש	flash	flash	flash
פֿלוי	floy	floy	floy
פֿלוים	floym	floym	floym
פֿלי	fli	fli	fly
פֿליג	flig	flig	flyg
פֿליגל	fligl	fligl	flygl
פֿלײט	fleyt	fleyt	flyyt
פֿלײטיסט	fleytist	fleytist	flyytyst
פֿלײש	fleysh	fleysh	flyysh
פֿליפֿעלד	flifeld	flifeld	flyfeld
פֿלעדערמויז	fledermoyz	fledermoyz	fledermoyz
פֿעברואַר	februar	februar	februar
פֿעדער	feder	feder	feder
פֿעדעראַציע	federatsye	federatsye	federatsye
פֿעלד	feld	feld	feld
פֿעליעטאָן	felyeton	felyeton	felyeton
פֿעליעטאָניסט	felyetonist	felyetonist	felyetonyst
פֿעמיניזם	feminizm	feminizm	femynyzm
פֿעמיניסט	feminist	feminist	femynyst
פֿענצטער	fentster	fentster	fentster
פֿעפֿער	fefer	fefer	fefer
פֿעץ	fets	fets	fets
פֿערד	ferd	ferd	ferd
פֿערדבין	ferdbin	ferdbin	ferdbyn
פֿערדל	ferdl	ferdl	ferdl
פֿערטל	fertl	fertl	fertl
פֿעריס־ראָד	feris-rod	feris-rod	ferys-rod
פֿערישקע	ferishke	ferishke	feryshke
פֿערציקסטל	fertsikstl	fertsikstl	fertsykstl
פֿערצנטל	fertsntl	fertsntl	fertsntl
פֿערשקע	fershke	fershke	fershke
פֿראַגמענט	fragment	fragment	fragment
פֿראַגע	frage	frage	frage
פֿראַנצויז	frantsoyz	frantsoyz	frantsoyz
פֿראַנצײזיש	frantseyzish	frantseyzish	frantsyyzysh
פֿרוי	froy	froy	froy
פֿרוכט	frukht	frukht	frucht
פֿרומאַק	frumak	frumak	frumak
פֿרומקײַט	frumkayt	frumkayt	frumkayt
פֿרײד	freyd	freyd	fryyd
פֿרילינג	friling	friling	frylyng
פֿרימאָרגן	frimorgn	frimorgn	frymorgn
פֿרישטיק	frishtik	frishtik	fryshtyk
פֿרעגצײכן	fregtseykhn	fregtseykhn	fregtsyychn
פֿרעסער	freser	freser	freser
פֿרײַטיק	fraytik	fraytik	fraytyk
פֿרײַנד	fraynd	fraynd	fraynd
פֿרײַנדין	frayndin	frayndin	frayndyn
פֿרײַנדשאַפֿט	frayndshaft	frayndshaft	frayndshaft
פֿײַל	fayl	fayl	fayl
פֿײַער	fayer	fayer	fayer
פֿײַערל	fayerl	fayerl	fayerl
פֿײַערצונג	fayertsung	fayertsung	fayertsung
פֿײַפֿל	fayfl	fayfl	fayfl
פֿ׳	f'	fey׳	f׳
צאָל	tsol	tsol	tsol
צאַם	tsam	tsam	tsam
צאָן	tson	tson	tson
צאָנדאָקטער	tsondokter	tsondokter	tsondokter
צאָפּ	tsop	tsop	tsop
צאַפּנבערדל	tsapnberdl	tsapnberdl	tsapnberdl
צאַצקע	tsatske	tsatske	tsatske
צאַר	tsar	tsar	tsar
צאַרינע	tsarine	tsarine	tsaryne
צאַריצע	tsaritse	tsaritse	tsarytse
צדיק	tsadek	tsadek	tsdyk
צדקה	tsedoke	tsdoke	tsdkh
צדקת	tsadeykes	tsedeykes	tsdks
צוג	tsug	tsug	tsug
צוהערער	tsuherer	tsuherer	tsuherer
צװאַנציקסטל	tsvantsikstl	tsvantsikstl	tsvantsykstl
צװאָרעך	tsvorekh	tsvorekh	tsvorech
צװיט	tsvit	tsvit	tsvyt
צװילינג	tsviling	tsviling	tsvylyng
צװינטער	tsvinter	tsvinter	tsvynter
צװעלפֿטל	tsvelftl	tsvelftl	tsvelftl
צװײַג	tsvayg	tsvayg	tsvayg
צװײַגמעסער	tsvaygmeser	tsvaygmeser	tsvaygmeser
צונג	tsung	tsung	tsung
צוקונפֿט	tsukunft	tsukunft	tsukunft
צוקער	tsuker	tsuker	tsuker
צורה	tsure	tsure	tsurh
ציבעלע	tsibele	tsibele	tsybele
ציג	tsig	tsig	tsyg
ציגאַר	tsigar	tsigar	tsygar
ציגל	tsigl	tsigl	tsygl
ציגעלע	tsigele	tsigele	tsygele
ציגײַנער	tsigayner	tsigayner	tsygayner
ציוניזם	tsienizm	tsienizm	tsyunyzm
ציוניסט	tsienist	tsienist	tsyunyst
ציטער	tsiter	tsiter	tsyter
ציטראָן	tsitron	tsitron	tsytron
ציטרין	tsitrin	tsitrin	tsytryn
צײכן	tseykhn	tseykhn	tsyychn
צײנשטעכער	tseynshtekher	tseynshtekher	tsyynshtecher
ציל	tsil	tsil	tsyl
צילינדער	tsilinder	tsilinder	tsylynder
צימוקים־װײַן	tsimukim-vayn	tsimukim-vayn	tsymukym-vayn
צימעס	tsimes	tsimes	tsymes
צימער	tsimer	tsimer	tsymer
צימערינג	tsimering	tsimering	tsymeryng
צימרינג	tsimring	tsimring	tsymryng
צינק	tsink	tsink	tsynk
ציעניסט	tsienist	tsyenist	tsyenyst
ציִעניסט	tsienist	tsienist	tsienyst
ציץ	tsits	tsits	tsyts
ציצית	tsitsis	tsitses	tsytsys
ציצל	tsitsl	tsitsl	tsytsl
ציצע	tsitse	tsitse	tsytse
ציר	tsir	tsir	tsyr
צירונג	tsirung	tsirung	tsyrung
צניעות	tsnies	tsnies	tsnyeus
צעדערבוים	tsederboym	tsederboym	tsederboym
צענדליק	tsendlik	tsendlik	tsendlyk
צענזוס	tsenzus	tsenzus	tsenzus
צענטימעטער	tsentimeter	tsentimeter	tsentymeter
צענטל	tsentl	tsentl	tsentl
צענטער	tsenter	tsenter	tsenter
צענערלינג	tsenerling	tsenerling	tsenerlyng
צער	tsar	tsar	tser
צערקװע	tserkve	tserkve	tserkve
צפֿון	tsofn	tsofn	tsfun
צרה	tsore	tsore	tsrh
צײַט	tsayt	tsayt	tsayt
צײַטונג	tsaytung	tsaytung	tsaytung
צײַטפֿאָרמע	tsaytforme	tsaytforme	tsaytforme
צײַטשריפֿט	tsaytshrift	tsaytshrift	tsaytshryft
קאָבאַלט	kobalt	kobalt	kobalt
קאַגעבעשניק	kagebeshnik	kagebeshnik	kagebeshnyk
קאָװאַדלע	kovadle	kovadle	kovadle
קאָװאַל	koval	koval	koval
קאַװיאַר	kavyar	kavyar	kavyar
קאַװע	kave	kave	kave
קאָװעל	kovel	kovel	kovel
קאַװעניק	kavenik	kavenik	kavenyk
קאַװענע	kavene	kavene	kavene
קאָזאַק	kozak	kozak	kozak
קאַטאַלאָג	katalog	katalog	katalog
קאַטעגאָריע	kategorye	kategorye	kategorye
קאַטשער	katsher	katsher	katsher
קאַטשקע	katshke	katshke	katshke
קאָכבוך	kokhbukh	kokhbukh	kochbuch
קאַלאָש	kalosh	kalosh	kalosh
קאָלװירטניק	kolvirtnik	kolvirtnik	kolvyrtnyk
קאַליום	kalyum	kalyum	kalyum
קאַליפֿיאָר	kalifyor	kalifyor	kalyfyor
קאַליקע	kalike	kalike	kalyke
קאָליר	kolir	kolir	kolyr
קאָלכאָז	kolkhoz	kolkhoz	kolchoz
קאָלכאָזניק	kolkhoznik	kolkhoznik	kolchoznyk
קאַלע	kale	kale	kale
קאָלעג	koleg	koleg	koleg
קאָלעגין	kolegin	kolegin	kolegyn
קאָלעגע	kolege	kolege	kolege
קאַלענדאַר	kalendar	kalendar	kalendar
קאַלציום	kaltsyum	kaltsyum	kaltsyum
קאַלקולוס	kalkulus	kalkulus	kalkulus
קאַלקע	kalke	kalke	kalke
קאַם	kam	kam	kam
קאַמאָד	kamod	kamod	kamod
קאָמאָד	komod	komod	komod
קאָמאָדע	komode	komode	komode
קאָמאַר	komar	komar	komar
קאָמוניזם	komunizm	komunizm	komunyzm
קאָמוניסט	komunist	komunist	komunyst
קאָמוניסטקע	komunistke	komunistke	komunystke
קאָמיטעט	komitet	komitet	komytet
קאַמיש	kamish	kamish	kamysh
קאָמע	kome	kome	kome
קאָמעדיע	komedye	komedye	komedye
קאַמף	kamf	kamf	kamf
קאָמפּאָזיטאָר	kompozitor	kompozitor	kompozytor
קאַמפּאַניע	kampanye	kampanye	kampanye
קאָמפּיוטער	kompyuter	kompyuter	kompyuter
קאָן	kon	kon	kon
קאַנאַריק	kanarik	kanarik	kanaryk
קאָנגרעס	kongres	kongres	kongres
קאָנדוקטאָר	konduktor	konduktor	konduktor
קאָנװערב	konverb	konverb	konverb
קאַנטאָניסט	kantonist	kantonist	kantonyst
קאָנטע	konte	konte	konte
קאָנטראָליאָר	kontrolyor	kontrolyor	kontrolyor
קאָנטראַקט	kontrakt	kontrakt	kontrakt
קאָניוגאַציע	konyugatsye	konyugatsye	konyugatsye
קאָניונקטיװ	konyunktiv	konyunktiv	konyunktyv
קאָנסטיטוציע	konstitutsye	konstitutsye	konstytutsye
קאָנפֿערענץ	konferents	konferents	konferents
קאָנצערט	kontsert	kontsert	kontsert
קאַסטן	kastn	kastn	kastn
קאַסטע	kaste	kaste	kaste
קאָסמאָנויט	kosmonoyt	kosmonoyt	kosmonoyt
קאָסמאָס	kosmos	kosmos	kosmos
קאָפּ	kop	kop	kop
קאַפּיטאַל	kapital	kapital	kapytal
קאַפּיטאַליזם	kapitalizm	kapitalizm	kapytalyzm
קאַפּיטאַליסט	kapitalist	kapitalist	kapytalyst
קאַפּיטל	kapitl	kapitl	kapytl
קאַפּעליוש	kapelyush	kapelyush	kapelyush
קאָפּעקע	kopeke	kopeke	kopeke
קאַפּער	kaper	kaper	kaper
קאַפֿע	kafe	kafe	kafe
קאַץ	kats	kats	kats
קאַקאַאָ	kakao	kakao	kakao
קאַקער	kaker	kaker	kaker
קאָרט	kort	kort	kort
קאַרטאָן	karton	karton	karton
קאַרטאָפֿל	kartofl	kartofl	kartofl
קאַרטאָפֿליע	kartoflye	kartoflye	kartoflye
קאַרטע	karte	karte	karte
קאַריקאַטור	karikatur	karikatur	karykatur
קאָרן	korn	korn	korn
קאָרנברויט	kornbroyt	kornbroyt	kornbroyt
קאָרע	kore	kore	kore
קאַרפּ	karp	karp	karp
קאַרש	karsh	karsh	karsh
קאַרשנבוים	karshnboym	karshnboym	karshnboym
קאָשטשאָל	koshtshol	koshtshol	koshtshol
קאָשיק	koshik	koshik	koshyk
קאָשיקל	koshikl	koshikl	koshykl
קאָשמאַר	koshmar	koshmar	koshmar
קאַשע	kashe	kashe	kashe
קאפ	kop	kפ	kaf
קאפעלע	kapele	kפele	kafele
קבֿר	keyver	keyver	kvr
קבֿרות	kvores	kvores	kvrus
קבלה	kabole	kabole	kblh
קדוש	kodesh	kodesh	kdush
קדושה	kdushe	kdushe	kdushh
קדיש	kadesh	kadesh	kdysh
קהילה	kehile	kehile	khylh
קו	ku	ku	ku
קוגל	kugl	kugl	kugl
קװאָטע	kvote	kvote	kvote
קװאַטער	kvater	kvater	kvater
קװאַטערין	kvaterin	kvaterin	kvateryn
קװאַל	kval	kval	kval
קװיט	kvit	kvit	kvyt
קװיטונג	kvitung	kvitung	kvytung
קװיטל	kvitl	kvitl	kvytl
קװײט	kveyt	kveyt	kvyyt
קװעטשער	kvetsher	kvetsher	kvetsher
קוטשמע	kutshme	kutshme	kutshme
קויל	koyl	koyl	koyl
קוילנשטאָף	koylnshtof	koylnshtof	koylnshtof
קוימען	koymen	koymen	koymen
קויפֿמאַן	koyfman	koyfman	koyfman
קויש	koysh	koysh	koysh
קוישבאָל	koyshbol	koyshbol	koyshbol
קוכן	kukhn	kukhn	kuchn
קול	kol	kol	kul
קולטור	kultur	kultur	kultur
קונסט	kunst	kunst	kunst
קונץ	kunts	kunts	kunts
קונצנמאַכער	kuntsnmakher	kuntsnmakher	kuntsnmacher
קוסט	kust	kust	kust
קוסעלע	kusele	kusele	kusele
קופּער	kuper	kuper	kuper
קוראָפּאַטע	kuropate	kuropate	kuropate
קורװע	kurve	kurve	kurve
קורס	kurs	kurs	kurs
קוש	kush	kush	kush
קיבוץ	kibuts	kibuts	kybuts
קידוש	kidesh	kidesh	kydush
קיום	kiyem	kiem	kyum
קיטל	kitl	kitl	kytl
קײט	keyt	keyt	kyyt
קײסער	keyser	keyser	kyyser
קײשל	keyshl	keyshl	kyyshl
קיך	kikh	kikh	kych
קיכל	kikhl	kikhl	kychl
קילאָ	kilo	kilo	kylo
קילאָמעטער	kilometer	kilometer	kylometer
קימפּעט	kimpet	kimpet	kympet
קימפּעט־פּאַלאַטע	kimpet-palate	kimpet-palate	kympet-palate
קימפּעטאָרין	kimpetorin	kimpetorin	kympetoryn
קימפּעטקינד	kimpetkind	kimpetkind	kympetkynd
קין	kin	kin	kyn
קינאָ	kino	kino	kyno
קינבײן	kinbeyn	kinbeyn	kynbyyn
קינד	kind	kind	kynd
קינדעלע	kindele	kindele	kyndele
קינדערביכל	kinderbikhl	kinderbikhl	kynderbychl
קינדערגאָרטן	kindergortn	kindergortn	kyndergortn
קיניג	kinig	kinig	kynyg
קיניגין	kinigin	kinigin	kynygyn
קיניגל	kinigl	kinigl	kynygl
קינסטלער	kinstler	kinstler	kynstler
קינסטלערין	kinstlerin	kinstlerin	kynstleryn
קירזשנער	kirzhner	kirzhner	kyrzhner
קירך	kirkh	kirkh	kyrch
קירכע	kirkhe	kirkhe	kyrche
קישינעװער	kishinever	kishinever	kyshynever
קישן	kishn	kishn	kyshn
קישקע	kishke	kishke	kyshke
קלאָג	klog	klog	klog
קלאָגליד	kloglid	kloglid	kloglyd
קלאָגער	kloger	kloger	kloger
קלאַװיאַטור	klavyatur	klavyatur	klavyatur
קלאַס	klas	klas	klas
קלאַסנקאַמף	klasnkamf	klasnkamf	klasnkamf
קלאַרנעט	klarnet	klarnet	klarnet
קלאַרנעטיסט	klarnetist	klarnetist	klarnetyst
קלויסטער	kloyster	kloyster	kloyster
קלײ	kley	kley	klyy
קלימאַט	klimat	klimat	klymat
קליפּה	klipe	klipe	klyph
קללה	klole	klole	kllh
קלעזמער	klezmer	klezmer	klezmer
קמץ	komets	komets	kmts
קמץ־אַלף	komets-alef	kmts-alf	kmts-alf
קמץ־אלף	komets-alef	kmts-lf	kmts-alf
קנאָבל	knobl	knobl	knobl
קנאות	kanoes	knus	knus
קני	kni	kni	kny
קנײדל	kneydl	kneydl	knyydl
קניש	knish	knish	knysh
קנס	knas	knas	kns
קנעכט	knekht	knekht	knecht
קנעכל	knekhl	knekhl	knechl
קנײַפּער	knayper	knayper	knayper
קסילאָפֿאָן	ksilofon	ksilofon	ksylofon
קעז	kez	kez	kez
קעטשאָפּ	ketshop	ketshop	ketshop
קעלנער	kelner	kelner	kelner
קעלנערין	kelnerin	kelnerin	kelneryn
קעלנערשע	kelnershe	kelnershe	kelnershe
קעמל	keml	keml	keml
קעמפֿער	kemfer	kemfer	kemfer
קעניג	kenig	kenig	kenyg
קעניגין	kenigin	kenigin	kenygyn
קעפּל	kepl	kepl	kepl
קעצל	ketsl	ketsl	ketsl
קעצעלע	ketsele	ketsele	ketsele
קערן	kern	kern	kern
קערנדל	kerndl	kerndl	kerndl
קערניצע	kernitse	kernitse	kernytse
קערפּער	kerper	kerper	kerper
קעשענע	keshene	keshene	keshene
קעשענעװער	keshenever	keshenever	keshenever
קראָ	kro	kro	kro
קראַב	krab	krab	krab
קראַװאַט	kravat	kravat	kravat
קראָם	krom	krom	krom
קראַפֿט	kraft	kraft	kraft
קראָקאָדיל	krokodil	krokodil	krokodyl
קרבן	korbn	korbn	krbn
קרויט	kroyt	kroyt	kroyt
קרוין	kroyn	kroyn	kroyn
קרוינעלע	kroynele	kroynele	kroynele
קרופּניק	krupnik	krupnik	krupnyk
קריג	krig	krig	kryg
קריטיק	kritik	kritik	krytyk
קריטיקער	kritiker	kritiker	krytyker
קריניצע	krinitse	krinitse	krynytse
קריסט	krist	krist	kryst
קריפּטאָן	kripton	kripton	krypton
קרעם	krem	krem	krem
קרעמל	kreml	kreml	kreml
קרעמער	kremer	kremer	kremer
קרעניצע	krenitse	krenitse	krenytse
קרעפּל	krepl	krepl	krepl
קרעפּלפֿלײש	kreplfleysh	kreplfleysh	kreplflyysh
קרײַד	krayd	krayd	krayd
קרײַז	krayz	krayz	krayz
קשיא	kashe	kashe	kshya
ראָב	rob	rob	rob
ראַבינער	rabiner	rabiner	rabyner
ראָג	rog	rog	rog
ראָגאַל	rogal	rogal	rogal
ראָד	rod	rod	rod
ראַדזשאַ	radzha	radzha	radzha
ראַדיאָ	radyo	radyo	radyo
ראָװער	rover	rover	rover
ראָזשינקע	rozhinke	rozhinke	rozhynke
ראַט	rat	rat	rat
ראָט	rot	rot	rot
ראָטהויז	rothoyz	rothoyz	rothoyz
ראָלע	role	role	role
ראָמאַן	roman	roman	roman
ראַץ	rats	rats	rats
ראַציאָנאַליזם	ratsyonalizm	ratsyonalizm	ratsyonalyzm
ראַקעט	raket	raket	raket
ראָש־השנה	rosheshone	rosheshone	rosh-hshnh
ראשון	rishen	rishn	rashun
רב	reb	reb	rb
רבֿ	rov	rov	rv
רבי	rebe	rebe	rby
רבי־ניסל	rebe-nisl	rbi-nisl	rby-nysl
רבינו	rabeynu	rbinu	rbynu
רביניו	rebenyu	rebenyu	rbynyu
רביסטװע	rebistve	rebistve	rbystve
רביצין	rebetsin	rebetsn	rbytsyn
רבנו	rabeynu	rabeynu	rbnu
רגע	rege	rege	rge
רובֿ	rov	rov	ruv
רובל	rubl	rubl	rubl
רוגז	roygez	roygez	rugz
רוגזה	rugze	rugze	rugzh
רודער	ruder	ruder	ruder
רוח	ruekh	ruekh	ruch
רוחניות	rukhnies	rukhnies	ruchnyus
רויז	royz	royz	royz
רויטאַרמײער	roytarmeyer	roytarmeyer	roytarmyyer
רומעניש	rumenish	rumenish	rumenysh
רומענער	rumener	rumener	rumener
רוס	rus	rus	rus
רוסלענדער	ruslender	ruslender	ruslender
רוקן	rukn	rukn	rukn
רחמנות	rakhmones	rakhmones	rchmnus
ריטער	riter	riter	ryter
ריכטער	rikhter	rikhter	rychter
רינג	ring	ring	ryng
רינד	rind	rind	rynd
רינדפֿלײש	rindfleysh	rindfleysh	ryndflyysh
ריפּ	rip	rip	ryp
רעגירונג	regirung	regirung	regyrung
רעגלאַמענט	reglament	reglament	reglament
רעגן	regn	regn	regn
רעגן־בויגן	regn-boygn	regn-boygn	regn-boygn
רעגן־מאַנטל	regn-mantl	regn-mantl	regn-mantl
רעגנבויגן	regnboygn	regnboygn	regnboygn
רעדאַקטאָר	redaktor	redaktor	redaktor
רעדער	reder	reder	reder
רעװאָלװער	revolver	revolver	revolver
רעװאָלוציע	revolutsye	revolutsye	revolutsye
רעטעך	retekh	retekh	retech
רעטעכל	retekhl	retekhl	retechl
רעכט	rekht	rekht	recht
רעליגיע	religye	religye	relygye
רענדל	rendl	rendl	rendl
רעסטאָראַן	restoran	restoran	restoran
רעפֿאָרם	reform	reform	reform
רעפּובליק	republik	republik	republyk
רעפּעטיציע	repetitsye	repetitsye	repetytsye
רעפּערטואַר	repertuar	repertuar	repertuar
רעפֿערענדום	referendum	referendum	referendum
רעצעפּט	retsept	retsept	retsept
רעקל	rekl	rekl	rekl
רעשט	resht	resht	resht
רפֿואה	refue	refue	rfuah
רשע	roshe	roshe	rshe
רײַז	rayz	rayz	rayz
רײַכקײַט	raykhkayt	raykhkayt	raychkayt
ר׳	reb	reysh׳	r׳
שׂונא	soyne	soyne	suna
שׂטן	sotn	sotn	stn
שׂינאה	sine	sine	synah
שׂכירות	skhires	skhires	schyrus
שׂכל	seykhl	seykhl	schl
שׂכר	skhar	skhar	schr
שׂמחה	simkhe	smkhh	smchh
שׂנאה	sine	snh	snah
שׂרפֿה	sreyfe	sreyfe	srfh
שׂררה	srore	srore	srrh
שאָ	sho	sho	sho
שאָד	shod	shod	shod
שאָטן	shotn	shotn	shotn
שאָך	shokh	shokh	shoch
שאַכמאַט	shakhmat	shakhmat	shachmat
שאָכפֿיגור	shokhfigur	shokhfigur	shochfygur
שאַל	shal	shal	shal
שאַליקל	shalikl	shalikl	shalykl
שאַנדע	shande	shande	shande
שאָס	shos	shos	shos
שאָף	shof	shof	shof
שאַקאַל	shakal	shakal	shakal
שאַרבן	sharbn	sharbn	sharbn
שאלה	shayle	shayle	shalh
שבֿט	sheyvet	shvat	shvt
שבת	shabes	shabes	shbs
שד	sheyd	shed	shd
שדכן	shadkhn	shatkhn	shdchn
שװאַב	shvab	shvab	shvab
שװאָגער	shvoger	shvoger	shvoger
שװאָם	shvom	shvom	shvom
שװאַן	shvan	shvan	shvan
שװאַנץ	shvants	shvants	shvants
שװאַרצער	shvartser	shvartser	shvartser
שװיגער	shviger	shviger	shvyger
שװיץ	shvits	shvits	shvyts
שװיצבאָד	shvitsbod	shvitsbod	shvytsbod
שװעבל	shvebl	shvebl	shvebl
שװעגערין	shvegerin	shvegerin	shvegeryn
שװעדיש	shvedish	shvedish	shvedysh
שװעמל	shveml	shveml	shveml
שװעסטער	shvester	shvester	shvester
שװעסטערל	shvesterl	shvesterl	shvesterl
שװער	shver	shver	shver
שװערד	shverd	shverd	shverd
שוחט	shoykhet	shoykhet	shucht
שוטה	shoyte	shoyte	shuth
שויס	shoys	shoys	shoys
שוישפּילער	shoyshpiler	shoyshpiler	shoyshpyler
שוישפּילערין	shoyshpilerin	shoyshpilerin	shoyshpyleryn
שוך	shukh	shukh	shuch
שול	shul	shul	shul
שולד	shuld	shuld	shuld
שולע	shule	shule	shule
שוסטער	shuster	shuster	shuster
שופּ	shup	shup	shup
שופֿט	shoyfet	shoyfet	shuft
שופר	shoyfer	shuפreysh	shufr
שופֿר	shoyfer	shoyfer	shufr
שורש	shoyresh	shoyresh	shursh
שחור	shokher	shkhur	shchur
שחרית	shakhres	shakhres	shchrys
שטאָהל	shtohl	shtohl	shtohl
שטאַט	shtat	shtat	shtat
שטאָט	shtot	shtot	shtot
שטאָטגאָרטן	shtotgortn	shtotgortn	shtotgortn
שטאָל	shtol	shtol	shtol
שטאַפּל	shtapl	shtapl	shtapl
שטאַפֿעט	shtafet	shtafet	shtafet
שטאָקפֿיש	shtokfish	shtokfish	shtokfysh
שטוב	shtub	shtub	shtub
שטודיע	shtudye	shtudye	shtudye
שטויב	shtoyb	shtoyb	shtoyb
שטויבזויגער	shtoybzoyger	shtoybzoyger	shtoybzoyger
שטויבמאַשין	shtoybmashin	shtoybmashin	shtoybmashyn
שטול	shtul	shtul	shtul
שטופּ	shtup	shtup	shtup
שטורעם	shturem	shturem	shturem
שטות	shtus	shtus	shtus
שטותערײַ	shtuseray	shtuseray	shtuseray
שטיבל	shtibl	shtibl	shtybl
שטיװל	shtivl	shtivl	shtyvl
שטײן	shteyn	shteyn	shtyyn
שטיק	shtik	shtik	shtyk
שטיקל	shtikl	shtikl	shtykl
שטיקשטאָף	shtikshtof	shtikshtof	shtykshtof
שטעטל	shtetl	shtetl	shtetl
שטעכל־חזיר	shtekhl-khazer	shtekhl-khzir	shtechl-chzyr
שטעכלער	shtekhler	shtekhler	shtechler
שטעכער	shtekher	shtekher	shtecher
שטעקל	shtekl	shtekl	shtekl
שטעקן	shtekn	shtekn	shtekn
שטערן	shtern	shtern	shtern
שטראָם	shtrom	shtrom	shtrom
שטרודל	shtrudl	shtrudl	shtrudl
שטרוי	shtroy	shtroy	shtroy
שטריק	shtrik	shtrik	shtryk
שטרײַמל	shtrayml	shtrayml	shtrayml
שטשאַװ	shtshav	shtshav	shtshav
שידוך	shidekh	shidekh	shyduch
שײגעץ	sheygets	sheygets	shyygets
שײגעצל	sheygetsl	sheygetsl	shyygetsl
שײד	sheyd	sheyd	shyyd
שײטל	sheytl	sheytl	shyytl
שײך	shayekh	shayekh	shyych
שײן	sheyn	sheyn	shyyn
שײנקײט	sheynkeyt	sheynkeyt	shyynkyyt
שיכּור	shiker	shiker	shykur
שילד	shild	shild	shyld
שילדערונג	shilderung	shilderung	shylderung
שינקע	shinke	shinke	shynke
שיף	shif	shif	shyf
שיפֿל	shifl	shifl	shyfl
שיפֿער	shifer	shifer	shyfer
שיפֿערין	shiferin	shiferin	shyferyn
שיקסע	shikse	shikse	shykse
שיר	shir	shir	shyr
שירה	shire	shire	shyrh
שירעם	shirem	shirem	shyrem
שישקע	shishke	shishke	shyshke
שכינה	shkhine	shkhine	shchynh
שכן	shokhn	shokhn	shchn
שלאַכט	shlakht	shlakht	shlacht
שלאַכטמאַן	shlakhtman	shlakhtman	shlachtman
שלאַכטפֿעלד	shlakhtfeld	shlakhtfeld	shlachtfeld
שלאַנג	shlang	shlang	shlang
שלאָס	shlos	shlos	shlos
שלאָסער	shloser	shloser	shloser
שלאָף	shlof	shlof	shlof
שלאָפֿלאָזיקײט	shloflozikeyt	shloflozikeyt	shloflozykyyt
שלאָפֿצימער	shloftsimer	shloftsimer	shloftsymer
שלאַפֿקײט	shlafkeyt	shlafkeyt	shlafkyyt
שלאָפֿראָק	shlofrok	shlofrok	shlofrok
שלום	sholem	sholem	shlum
שלוש־סעודות	shaleshudes	shlush-seudus	shlush-seudus
שליוכע	shlyukhe	shlyukhe	shlyuche
שליח	shliekh	sheliekh	shlych
שלײקעס	shleykes	shleykes	shlyykes
שלימזל	shlimazl	shlimazl	shlymzl
שלימזלניצע	shlimazlnitse	shlimezalnitse	shlymzlnytse
שלימיל	shlimil	shlimil	shlymyl
שליסל	shlisl	shlisl	shlysl
שלעסל	shlesl	shlesl	shlesl
שמאַטע	shmate	shmate	shmate
שמאָך	shmokh	shmokh	shmoch
שמאַלץ	shmalts	shmalts	shmalts
שמאַנט	shmant	shmant	shmant
שמאָק	shmok	shmok	shmok
שמאָראַק	shmorak	shmorak	shmorak
שמועס	shmues	shmues	shmues
שמוץ	shmuts	shmuts	shmuts
שמיד	shmid	shmid	shmyd
שמידהאַמער	shmidhamer	shmidhamer	shmydhamer
שמײכל	shmeykhl	shmeykhl	shmyychl
שמיר	shmir	shmir	shmyr
שמירקעז	shmirkez	shmirkez	shmyrkez
שמעגעגע	shmegege	shmegege	shmegege
שמעק	shmek	shmek	shmek
שמעקל	shmekl	shmekl	shmekl
שמעקעלע	shmekele	shmekele	shmekele
שמערץ	shmerts	shmerts	shmerts
שמש	shames	shmsh	shmsh
שמשׂ	shames	shames	shms
שמשׂטע	shameste	shameste	shmste
שנאָז	shnoz	shnoz	shnoz
שנאַפּס	shnaps	shnaps	shnaps
שנאָרער	shnorer	shnorer	shnorer
שנור	shnur	shnur	shnur
שנײ	shney	shney	shnyy
שנײמענטש	shneymentsh	shneymentsh	shnyymentsh
שנײעלע	shneyele	shneyele	shnyyele
שניפּס	shnips	shnips	shnyps
שנירל	shnirl	shnirl	shnyrl
שנעק	shnek	shnek	shnek
שנײַדער	shnayder	shnayder	shnayder
שנײַדערוק	shnayderuk	shnayderuk	shnayderuk
שנײַדעריונג	shnayderyung	shnayderyung	shnayderyung
שנײַדערקע	shnayderke	shnayderke	shnayderke
שנײַדערײַ	shnayderay	shnayderay	shnayderay
שעה	sho	sho	sheh
שעפּטש	sheptsh	sheptsh	sheptsh
שעפּס	sheps	sheps	sheps
שער	sher	sher	sher
שערל	sherl	sherl	sherl
שערער	sherer	sherer	sherer
שערערין	shererin	shererin	shereryn
שפּאַלט	shpalt	shpalt	shpalt
שפּאַניער	shpanyer	shpanyer	shpanyer
שפּיאָן	shpyon	shpyon	shpyon
שפּיאָנאַזש	shpyonazh	shpyonazh	shpyonazh
שפּיגל	shpigl	shpigl	shpygl
שפּיז	shpiz	shpiz	shpyz
שפּיטאָל	shpitol	shpitol	shpytol
שפּיל	shpil	shpil	shpyl
שפּילער	shpiler	shpiler	shpyler
שפּילקע	shpilke	shpilke	shpylke
שפּין	shpin	shpin	shpyn
שפּינאַט	shpinat	shpinat	shpynat
שפּינװעב	shpinveb	shpinveb	shpynveb
שפּיץ	shpits	shpits	shpyts
שפּעק	shpek	shpek	shpek
שפּערל	shperl	shperl	shperl
שפּראַך	shprakh	shprakh	shprach
שפּראַך־װיסנשאַפֿט	shprakh-visnshaft	shprakh-visnshaft	shprach-vysnshaft
שפּראַכגעפֿיל	shprakhgefil	shprakhgefil	shprachgefyl
שפּריכװאָרט	shprikhvort	shprikhvort	shprychvort
שפּרינגער	shpringer	shpringer	shprynger
שפּריץ	shprits	shprits	shpryts
שפּײַעכץ	shpayekhts	shpayekhts	shpayechts
שפײעכץ	shpayekhts	shinפeyekhts	shfyyechts
שפֿלות	shifles	shflus	shflus
שקל	shekl	shekl	shkl
שקלאַף	shklaf	shklaf	shklaf
שרויף	shroyf	shroyf	shroyf
שרימפּ	shrimp	shrimp	shrymp
שריפֿט	shrift	shrift	shryft
שריפֿטשטעלער	shriftshteler	shriftshteler	shryftshteler
שרעק	shrek	shrek	shrek
שרײַבער	shrayber	shrayber	shrayber
שרײַבערין	shrayberin	shrayberin	shrayberyn
שתּדלן	shtadlen	shtadlen	shtdln
שתּדלנות	shtadlones	shtadlones	shtdlnus
שתוהל	shtuhl	shsuhl	shsuhl
שײַן	shayn	shayn	shayn
תּאוה	tayve	tuh	tuh
תּבֿה	teyve	teyve	tvh
תּבֿואה	tvue	tvue	tvuah
תּהום	tom	thom	thum
תּוך	tokh	tokh	tuch
תּחינה	tkhine	tkhine	tchynh
תּחת	tokhes	tokhes	tchs
תּחת לעקער	tokhes-leker	tokhes leker	tchs leker
תּיפֿלה	tifle	tifle	tyflh
תּיקון	tikn	tikn	tykun
תּירוץ	teyrets	terets	tyruts
תּישעה־באָבֿ	tishebov	tishebov	tysheh-bov
תּכשיט	takhshet	takhshet	tchshyt
תּל	tel	tel	tl
תּליה	tliye	tlie	tlyh
תּליון	talyen	tlyun	tlyun
תּלין	talyen	talyen	tlyn
תּלמוד־תּורה	talmetoyre	talmetoyre	tlmud-turh
תּלמיד	talmed	talmed	tlmyd
תּלמיד־חכם	talmid-khokhem	talmed-khokhem	tlmyd-chchm
תּלמידה	talmido	talmide	tlmydh
תּם	tam	tam	tm
תּמוז	tamez	tamez	tmuz
תּמימות	temimes	tmimes	tmymus
תּנא	tane	tane	tna
תּנאַי	tnay	tnay	tnay
תּענית	tones	tones	tenys
תּפֿילה	tfile	tfile	tfylh
תּפֿילין	tfiln	tfiln	tfylyn
תּפֿיסה	tfise	tfise	tfysh
תּקופֿה	tkufe	tkufe	tkufh
תּקנה	takone	takone	tknh
תּרגום	targem	targem	trgum
תּשובֿה	tshuve	tshuve	tshuvh
תּשליך	tashlekh	tashlekh	tshlych
תּשעה־באָבֿ	tishebov	tsheh-bov	tsheh-bov
תּשרי	tishre	tshri	tshry
תחת	tokhes	skhs	schs
